년도,시도,총 인구,남성 인구,여성 인구,주택수,빈집수
2013,서울특별시,10143645,5007869,5135776,,
2013,부산광역시,3527635,1747000,1780635,,
2013,대구광역시,2501588,1246071,1255517,,
2013,인천광역시,2879782,1448835,1430947,,
2013,광주광역시,1472910,730216,742694,,
2013,대전광역시,1532811,767309,765502,,
2013,울산광역시,1156480,595319,561161,,
2013,세종특별자치시,122153,62205,59948,,
2013,경기도,12234630,6159193,6075437,,
2013,강원도,1542263,776498,765765,,
2013,충청북도,1572732,792862,779870,,
2013,충청남도,2047631,1037421,1010210,,
2013,전라북도,1872965,932894,940071,,
2013,전라남도,1907172,952597,954575,,
2013,경상북도,2699440,1355951,1343489,,
2013,경상남도,3333820,1678592,1655228,,
2013,제주특별자치도,593806,297504,296302,,
2014,서울특별시,10103233,4979768,5123465,,
2014,부산광역시,3519401,1740417,1778984,,
2014,대구광역시,2493264,1241119,1252145,,
2014,인천광역시,2902608,1459074,1443534,,
2014,광주광역시,1475884,731339,744545,,
2014,대전광역시,1531809,766497,765312,,
2014,울산광역시,1166377,600904,565473,,
2014,세종특별자치시,156125,78862,77263,,
2014,경기도,12357830,6219813,6138017,,
2014,강원도,1544442,778007,766435,,
2014,충청북도,1578933,796141,782792,,
2014,충청남도,2062273,1045892,1016381,,
2014,전라북도,1871560,931536,940024,,
2014,전라남도,1905780,951975,953805,,
2014,경상북도,2700794,1356182,1344612,,
2014,경상남도,3350257,1687114,1663143,,
2014,제주특별자치도,607346,304656,302690,,
2015,서울특별시,10022181,4930943,5091238,2793244,79049
2015,서울특별시,10022181,4930943,5091238,1164352,86626
2015,서울특별시,10022181,4930943,5091238,738100,29610
2015,서울특별시,10022181,4930943,5091238,942244,47402
2015,서울특별시,10022181,4930943,5091238,486527,26705
2015,서울특별시,10022181,4930943,5091238,468885,26419
2015,서울특별시,10022181,4930943,5091238,357674,21423
2015,서울특별시,10022181,4930943,5091238,81130,16458
2015,서울특별시,10022181,4930943,5091238,3693557,144893
2015,서울특별시,10022181,4930943,5091238,569899,59260
2015,서울특별시,10022181,4930943,5091238,556951,54884
2015,서울특별시,10022181,4930943,5091238,754372,73719
2015,서울특별시,10022181,4930943,5091238,687103,73869
2015,서울특별시,10022181,4930943,5091238,747621,103333
2015,서울특별시,10022181,4930943,5091238,995385,108114
2015,서울특별시,10022181,4930943,5091238,1134738,98680
2015,서울특별시,10022181,4930943,5091238,195224,18475
2015,부산광역시,3513777,1735570,1778207,2793244,79049
2015,부산광역시,3513777,1735570,1778207,1164352,86626
2015,부산광역시,3513777,1735570,1778207,738100,29610
2015,부산광역시,3513777,1735570,1778207,942244,47402
2015,부산광역시,3513777,1735570,1778207,486527,26705
2015,부산광역시,3513777,1735570,1778207,468885,26419
2015,부산광역시,3513777,1735570,1778207,357674,21423
2015,부산광역시,3513777,1735570,1778207,81130,16458
2015,부산광역시,3513777,1735570,1778207,3693557,144893
2015,부산광역시,3513777,1735570,1778207,569899,59260
2015,부산광역시,3513777,1735570,1778207,556951,54884
2015,부산광역시,3513777,1735570,1778207,754372,73719
2015,부산광역시,3513777,1735570,1778207,687103,73869
2015,부산광역시,3513777,1735570,1778207,747621,103333
2015,부산광역시,3513777,1735570,1778207,995385,108114
2015,부산광역시,3513777,1735570,1778207,1134738,98680
2015,부산광역시,3513777,1735570,1778207,195224,18475
2015,대구광역시,2487829,1237291,1250538,2793244,79049
2015,대구광역시,2487829,1237291,1250538,1164352,86626
2015,대구광역시,2487829,1237291,1250538,738100,29610
2015,대구광역시,2487829,1237291,1250538,942244,47402
2015,대구광역시,2487829,1237291,1250538,486527,26705
2015,대구광역시,2487829,1237291,1250538,468885,26419
2015,대구광역시,2487829,1237291,1250538,357674,21423
2015,대구광역시,2487829,1237291,1250538,81130,16458
2015,대구광역시,2487829,1237291,1250538,3693557,144893
2015,대구광역시,2487829,1237291,1250538,569899,59260
2015,대구광역시,2487829,1237291,1250538,556951,54884
2015,대구광역시,2487829,1237291,1250538,754372,73719
2015,대구광역시,2487829,1237291,1250538,687103,73869
2015,대구광역시,2487829,1237291,1250538,747621,103333
2015,대구광역시,2487829,1237291,1250538,995385,108114
2015,대구광역시,2487829,1237291,1250538,1134738,98680
2015,대구광역시,2487829,1237291,1250538,195224,18475
2015,인천광역시,2925815,1469869,1455946,2793244,79049
2015,인천광역시,2925815,1469869,1455946,1164352,86626
2015,인천광역시,2925815,1469869,1455946,738100,29610
2015,인천광역시,2925815,1469869,1455946,942244,47402
2015,인천광역시,2925815,1469869,1455946,486527,26705
2015,인천광역시,2925815,1469869,1455946,468885,26419
2015,인천광역시,2925815,1469869,1455946,357674,21423
2015,인천광역시,2925815,1469869,1455946,81130,16458
2015,인천광역시,2925815,1469869,1455946,3693557,144893
2015,인천광역시,2925815,1469869,1455946,569899,59260
2015,인천광역시,2925815,1469869,1455946,556951,54884
2015,인천광역시,2925815,1469869,1455946,754372,73719
2015,인천광역시,2925815,1469869,1455946,687103,73869
2015,인천광역시,2925815,1469869,1455946,747621,103333
2015,인천광역시,2925815,1469869,1455946,995385,108114
2015,인천광역시,2925815,1469869,1455946,1134738,98680
2015,인천광역시,2925815,1469869,1455946,195224,18475
2015,광주광역시,1472199,729662,742537,2793244,79049
2015,광주광역시,1472199,729662,742537,1164352,86626
2015,광주광역시,1472199,729662,742537,738100,29610
2015,광주광역시,1472199,729662,742537,942244,47402
2015,광주광역시,1472199,729662,742537,486527,26705
2015,광주광역시,1472199,729662,742537,468885,26419
2015,광주광역시,1472199,729662,742537,357674,21423
2015,광주광역시,1472199,729662,742537,81130,16458
2015,광주광역시,1472199,729662,742537,3693557,144893
2015,광주광역시,1472199,729662,742537,569899,59260
2015,광주광역시,1472199,729662,742537,556951,54884
2015,광주광역시,1472199,729662,742537,754372,73719
2015,광주광역시,1472199,729662,742537,687103,73869
2015,광주광역시,1472199,729662,742537,747621,103333
2015,광주광역시,1472199,729662,742537,995385,108114
2015,광주광역시,1472199,729662,742537,1134738,98680
2015,광주광역시,1472199,729662,742537,195224,18475
2015,대전광역시,1518775,759778,758997,2793244,79049
2015,대전광역시,1518775,759778,758997,1164352,86626
2015,대전광역시,1518775,759778,758997,738100,29610
2015,대전광역시,1518775,759778,758997,942244,47402
2015,대전광역시,1518775,759778,758997,486527,26705
2015,대전광역시,1518775,759778,758997,468885,26419
2015,대전광역시,1518775,759778,758997,357674,21423
2015,대전광역시,1518775,759778,758997,81130,16458
2015,대전광역시,1518775,759778,758997,3693557,144893
2015,대전광역시,1518775,759778,758997,569899,59260
2015,대전광역시,1518775,759778,758997,556951,54884
2015,대전광역시,1518775,759778,758997,754372,73719
2015,대전광역시,1518775,759778,758997,687103,73869
2015,대전광역시,1518775,759778,758997,747621,103333
2015,대전광역시,1518775,759778,758997,995385,108114
2015,대전광역시,1518775,759778,758997,1134738,98680
2015,대전광역시,1518775,759778,758997,195224,18475
2015,울산광역시,1173534,604889,568645,2793244,79049
2015,울산광역시,1173534,604889,568645,1164352,86626
2015,울산광역시,1173534,604889,568645,738100,29610
2015,울산광역시,1173534,604889,568645,942244,47402
2015,울산광역시,1173534,604889,568645,486527,26705
2015,울산광역시,1173534,604889,568645,468885,26419
2015,울산광역시,1173534,604889,568645,357674,21423
2015,울산광역시,1173534,604889,568645,81130,16458
2015,울산광역시,1173534,604889,568645,3693557,144893
2015,울산광역시,1173534,604889,568645,569899,59260
2015,울산광역시,1173534,604889,568645,556951,54884
2015,울산광역시,1173534,604889,568645,754372,73719
2015,울산광역시,1173534,604889,568645,687103,73869
2015,울산광역시,1173534,604889,568645,747621,103333
2015,울산광역시,1173534,604889,568645,995385,108114
2015,울산광역시,1173534,604889,568645,1134738,98680
2015,울산광역시,1173534,604889,568645,195224,18475
2015,세종특별자치시,210884,105752,105132,2793244,79049
2015,세종특별자치시,210884,105752,105132,1164352,86626
2015,세종특별자치시,210884,105752,105132,738100,29610
2015,세종특별자치시,210884,105752,105132,942244,47402
2015,세종특별자치시,210884,105752,105132,486527,26705
2015,세종특별자치시,210884,105752,105132,468885,26419
2015,세종특별자치시,210884,105752,105132,357674,21423
2015,세종특별자치시,210884,105752,105132,81130,16458
2015,세종특별자치시,210884,105752,105132,3693557,144893
2015,세종특별자치시,210884,105752,105132,569899,59260
2015,세종특별자치시,210884,105752,105132,556951,54884
2015,세종특별자치시,210884,105752,105132,754372,73719
2015,세종특별자치시,210884,105752,105132,687103,73869
2015,세종특별자치시,210884,105752,105132,747621,103333
2015,세종특별자치시,210884,105752,105132,995385,108114
2015,세종특별자치시,210884,105752,105132,1134738,98680
2015,세종특별자치시,210884,105752,105132,195224,18475
2015,경기도,12522606,6299812,6222794,2793244,79049
2015,경기도,12522606,6299812,6222794,1164352,86626
2015,경기도,12522606,6299812,6222794,738100,29610
2015,경기도,12522606,6299812,6222794,942244,47402
2015,경기도,12522606,6299812,6222794,486527,26705
2015,경기도,12522606,6299812,6222794,468885,26419
2015,경기도,12522606,6299812,6222794,357674,21423
2015,경기도,12522606,6299812,6222794,81130,16458
2015,경기도,12522606,6299812,6222794,3693557,144893
2015,경기도,12522606,6299812,6222794,569899,59260
2015,경기도,12522606,6299812,6222794,556951,54884
2015,경기도,12522606,6299812,6222794,754372,73719
2015,경기도,12522606,6299812,6222794,687103,73869
2015,경기도,12522606,6299812,6222794,747621,103333
2015,경기도,12522606,6299812,6222794,995385,108114
2015,경기도,12522606,6299812,6222794,1134738,98680
2015,경기도,12522606,6299812,6222794,195224,18475
2015,강원도,1549507,781434,768073,2793244,79049
2015,강원도,1549507,781434,768073,1164352,86626
2015,강원도,1549507,781434,768073,738100,29610
2015,강원도,1549507,781434,768073,942244,47402
2015,강원도,1549507,781434,768073,486527,26705
2015,강원도,1549507,781434,768073,468885,26419
2015,강원도,1549507,781434,768073,357674,21423
2015,강원도,1549507,781434,768073,81130,16458
2015,강원도,1549507,781434,768073,3693557,144893
2015,강원도,1549507,781434,768073,569899,59260
2015,강원도,1549507,781434,768073,556951,54884
2015,강원도,1549507,781434,768073,754372,73719
2015,강원도,1549507,781434,768073,687103,73869
2015,강원도,1549507,781434,768073,747621,103333
2015,강원도,1549507,781434,768073,995385,108114
2015,강원도,1549507,781434,768073,1134738,98680
2015,강원도,1549507,781434,768073,195224,18475
2015,충청북도,1583952,798896,785056,2793244,79049
2015,충청북도,1583952,798896,785056,1164352,86626
2015,충청북도,1583952,798896,785056,738100,29610
2015,충청북도,1583952,798896,785056,942244,47402
2015,충청북도,1583952,798896,785056,486527,26705
2015,충청북도,1583952,798896,785056,468885,26419
2015,충청북도,1583952,798896,785056,357674,21423
2015,충청북도,1583952,798896,785056,81130,16458
2015,충청북도,1583952,798896,785056,3693557,144893
2015,충청북도,1583952,798896,785056,569899,59260
2015,충청북도,1583952,798896,785056,556951,54884
2015,충청북도,1583952,798896,785056,754372,73719
2015,충청북도,1583952,798896,785056,687103,73869
2015,충청북도,1583952,798896,785056,747621,103333
2015,충청북도,1583952,798896,785056,995385,108114
2015,충청북도,1583952,798896,785056,1134738,98680
2015,충청북도,1583952,798896,785056,195224,18475
2015,충청남도,2077649,1054439,1023210,2793244,79049
2015,충청남도,2077649,1054439,1023210,1164352,86626
2015,충청남도,2077649,1054439,1023210,738100,29610
2015,충청남도,2077649,1054439,1023210,942244,47402
2015,충청남도,2077649,1054439,1023210,486527,26705
2015,충청남도,2077649,1054439,1023210,468885,26419
2015,충청남도,2077649,1054439,1023210,357674,21423
2015,충청남도,2077649,1054439,1023210,81130,16458
2015,충청남도,2077649,1054439,1023210,3693557,144893
2015,충청남도,2077649,1054439,1023210,569899,59260
2015,충청남도,2077649,1054439,1023210,556951,54884
2015,충청남도,2077649,1054439,1023210,754372,73719
2015,충청남도,2077649,1054439,1023210,687103,73869
2015,충청남도,2077649,1054439,1023210,747621,103333
2015,충청남도,2077649,1054439,1023210,995385,108114
2015,충청남도,2077649,1054439,1023210,1134738,98680
2015,충청남도,2077649,1054439,1023210,195224,18475
2015,전라북도,1869711,930255,939456,2793244,79049
2015,전라북도,1869711,930255,939456,1164352,86626
2015,전라북도,1869711,930255,939456,738100,29610
2015,전라북도,1869711,930255,939456,942244,47402
2015,전라북도,1869711,930255,939456,486527,26705
2015,전라북도,1869711,930255,939456,468885,26419
2015,전라북도,1869711,930255,939456,357674,21423
2015,전라북도,1869711,930255,939456,81130,16458
2015,전라북도,1869711,930255,939456,3693557,144893
2015,전라북도,1869711,930255,939456,569899,59260
2015,전라북도,1869711,930255,939456,556951,54884
2015,전라북도,1869711,930255,939456,754372,73719
2015,전라북도,1869711,930255,939456,687103,73869
2015,전라북도,1869711,930255,939456,747621,103333
2015,전라북도,1869711,930255,939456,995385,108114
2015,전라북도,1869711,930255,939456,1134738,98680
2015,전라북도,1869711,930255,939456,195224,18475
2015,전라남도,1908996,953881,955115,2793244,79049
2015,전라남도,1908996,953881,955115,1164352,86626
2015,전라남도,1908996,953881,955115,738100,29610
2015,전라남도,1908996,953881,955115,942244,47402
2015,전라남도,1908996,953881,955115,486527,26705
2015,전라남도,1908996,953881,955115,468885,26419
2015,전라남도,1908996,953881,955115,357674,21423
2015,전라남도,1908996,953881,955115,81130,16458
2015,전라남도,1908996,953881,955115,3693557,144893
2015,전라남도,1908996,953881,955115,569899,59260
2015,전라남도,1908996,953881,955115,556951,54884
2015,전라남도,1908996,953881,955115,754372,73719
2015,전라남도,1908996,953881,955115,687103,73869
2015,전라남도,1908996,953881,955115,747621,103333
2015,전라남도,1908996,953881,955115,995385,108114
2015,전라남도,1908996,953881,955115,1134738,98680
2015,전라남도,1908996,953881,955115,195224,18475
2015,경상북도,2702826,1357306,1345520,2793244,79049
2015,경상북도,2702826,1357306,1345520,1164352,86626
2015,경상북도,2702826,1357306,1345520,738100,29610
2015,경상북도,2702826,1357306,1345520,942244,47402
2015,경상북도,2702826,1357306,1345520,486527,26705
2015,경상북도,2702826,1357306,1345520,468885,26419
2015,경상북도,2702826,1357306,1345520,357674,21423
2015,경상북도,2702826,1357306,1345520,81130,16458
2015,경상북도,2702826,1357306,1345520,3693557,144893
2015,경상북도,2702826,1357306,1345520,569899,59260
2015,경상북도,2702826,1357306,1345520,556951,54884
2015,경상북도,2702826,1357306,1345520,754372,73719
2015,경상북도,2702826,1357306,1345520,687103,73869
2015,경상북도,2702826,1357306,1345520,747621,103333
2015,경상북도,2702826,1357306,1345520,995385,108114
2015,경상북도,2702826,1357306,1345520,1134738,98680
2015,경상북도,2702826,1357306,1345520,195224,18475
2015,경상남도,3364702,1694981,1669721,2793244,79049
2015,경상남도,3364702,1694981,1669721,1164352,86626
2015,경상남도,3364702,1694981,1669721,738100,29610
2015,경상남도,3364702,1694981,1669721,942244,47402
2015,경상남도,3364702,1694981,1669721,486527,26705
2015,경상남도,3364702,1694981,1669721,468885,26419
2015,경상남도,3364702,1694981,1669721,357674,21423
2015,경상남도,3364702,1694981,1669721,81130,16458
2015,경상남도,3364702,1694981,1669721,3693557,144893
2015,경상남도,3364702,1694981,1669721,569899,59260
2015,경상남도,3364702,1694981,1669721,556951,54884
2015,경상남도,3364702,1694981,1669721,754372,73719
2015,경상남도,3364702,1694981,1669721,687103,73869
2015,경상남도,3364702,1694981,1669721,747621,103333
2015,경상남도,3364702,1694981,1669721,995385,108114
2015,경상남도,3364702,1694981,1669721,1134738,98680
2015,경상남도,3364702,1694981,1669721,195224,18475
2015,제주특별자치도,624395,313428,310967,2793244,79049
2015,제주특별자치도,624395,313428,310967,1164352,86626
2015,제주특별자치도,624395,313428,310967,738100,29610
2015,제주특별자치도,624395,313428,310967,942244,47402
2015,제주특별자치도,624395,313428,310967,486527,26705
2015,제주특별자치도,624395,313428,310967,468885,26419
2015,제주특별자치도,624395,313428,310967,357674,21423
2015,제주특별자치도,624395,313428,310967,81130,16458
2015,제주특별자치도,624395,313428,310967,3693557,144893
2015,제주특별자치도,624395,313428,310967,569899,59260
2015,제주특별자치도,624395,313428,310967,556951,54884
2015,제주특별자치도,624395,313428,310967,754372,73719
2015,제주특별자치도,624395,313428,310967,687103,73869
2015,제주특별자치도,624395,313428,310967,747621,103333
2015,제주특별자치도,624395,313428,310967,995385,108114
2015,제주특별자치도,624395,313428,310967,1134738,98680
2015,제주특별자치도,624395,313428,310967,195224,18475
2016,서울특별시,9930616,4876789,5053827,2830857,94668
2016,서울특별시,9930616,4876789,5053827,1174034,85333
2016,서울특별시,9930616,4876789,5053827,761054,36932
2016,서울특별시,9930616,4876789,5053827,958072,52941
2016,서울특별시,9930616,4876789,5053827,494547,29127
2016,서울특별시,9930616,4876789,5053827,474193,26238
2016,서울특별시,9930616,4876789,5053827,361273,20965
2016,서울특별시,9930616,4876789,5053827,86607,10115
2016,서울특별시,9930616,4876789,5053827,3814834,167830
2016,서울특별시,9930616,4876789,5053827,575967,55709
2016,서울특별시,9930616,4876789,5053827,568567,56014
2016,서울특별시,9930616,4876789,5053827,776746,80152
2016,서울특별시,9930616,4876789,5053827,692563,73696
2016,서울특별시,9930616,4876789,5053827,755044,102257
2016,서울특별시,9930616,4876789,5053827,1009941,107862
2016,서울특별시,9930616,4876789,5053827,1151057,98899
2016,서울특별시,9930616,4876789,5053827,206874,21469
2016,부산광역시,3498529,1725607,1772922,2830857,94668
2016,부산광역시,3498529,1725607,1772922,1174034,85333
2016,부산광역시,3498529,1725607,1772922,761054,36932
2016,부산광역시,3498529,1725607,1772922,958072,52941
2016,부산광역시,3498529,1725607,1772922,494547,29127
2016,부산광역시,3498529,1725607,1772922,474193,26238
2016,부산광역시,3498529,1725607,1772922,361273,20965
2016,부산광역시,3498529,1725607,1772922,86607,10115
2016,부산광역시,3498529,1725607,1772922,3814834,167830
2016,부산광역시,3498529,1725607,1772922,575967,55709
2016,부산광역시,3498529,1725607,1772922,568567,56014
2016,부산광역시,3498529,1725607,1772922,776746,80152
2016,부산광역시,3498529,1725607,1772922,692563,73696
2016,부산광역시,3498529,1725607,1772922,755044,102257
2016,부산광역시,3498529,1725607,1772922,1009941,107862
2016,부산광역시,3498529,1725607,1772922,1151057,98899
2016,부산광역시,3498529,1725607,1772922,206874,21469
2016,대구광역시,2484557,1234169,1250388,2830857,94668
2016,대구광역시,2484557,1234169,1250388,1174034,85333
2016,대구광역시,2484557,1234169,1250388,761054,36932
2016,대구광역시,2484557,1234169,1250388,958072,52941
2016,대구광역시,2484557,1234169,1250388,494547,29127
2016,대구광역시,2484557,1234169,1250388,474193,26238
2016,대구광역시,2484557,1234169,1250388,361273,20965
2016,대구광역시,2484557,1234169,1250388,86607,10115
2016,대구광역시,2484557,1234169,1250388,3814834,167830
2016,대구광역시,2484557,1234169,1250388,575967,55709
2016,대구광역시,2484557,1234169,1250388,568567,56014
2016,대구광역시,2484557,1234169,1250388,776746,80152
2016,대구광역시,2484557,1234169,1250388,692563,73696
2016,대구광역시,2484557,1234169,1250388,755044,102257
2016,대구광역시,2484557,1234169,1250388,1009941,107862
2016,대구광역시,2484557,1234169,1250388,1151057,98899
2016,대구광역시,2484557,1234169,1250388,206874,21469
2016,인천광역시,2943069,1477671,1465398,2830857,94668
2016,인천광역시,2943069,1477671,1465398,1174034,85333
2016,인천광역시,2943069,1477671,1465398,761054,36932
2016,인천광역시,2943069,1477671,1465398,958072,52941
2016,인천광역시,2943069,1477671,1465398,494547,29127
2016,인천광역시,2943069,1477671,1465398,474193,26238
2016,인천광역시,2943069,1477671,1465398,361273,20965
2016,인천광역시,2943069,1477671,1465398,86607,10115
2016,인천광역시,2943069,1477671,1465398,3814834,167830
2016,인천광역시,2943069,1477671,1465398,575967,55709
2016,인천광역시,2943069,1477671,1465398,568567,56014
2016,인천광역시,2943069,1477671,1465398,776746,80152
2016,인천광역시,2943069,1477671,1465398,692563,73696
2016,인천광역시,2943069,1477671,1465398,755044,102257
2016,인천광역시,2943069,1477671,1465398,1009941,107862
2016,인천광역시,2943069,1477671,1465398,1151057,98899
2016,인천광역시,2943069,1477671,1465398,206874,21469
2016,광주광역시,1469214,728137,741077,2830857,94668
2016,광주광역시,1469214,728137,741077,1174034,85333
2016,광주광역시,1469214,728137,741077,761054,36932
2016,광주광역시,1469214,728137,741077,958072,52941
2016,광주광역시,1469214,728137,741077,494547,29127
2016,광주광역시,1469214,728137,741077,474193,26238
2016,광주광역시,1469214,728137,741077,361273,20965
2016,광주광역시,1469214,728137,741077,86607,10115
2016,광주광역시,1469214,728137,741077,3814834,167830
2016,광주광역시,1469214,728137,741077,575967,55709
2016,광주광역시,1469214,728137,741077,568567,56014
2016,광주광역시,1469214,728137,741077,776746,80152
2016,광주광역시,1469214,728137,741077,692563,73696
2016,광주광역시,1469214,728137,741077,755044,102257
2016,광주광역시,1469214,728137,741077,1009941,107862
2016,광주광역시,1469214,728137,741077,1151057,98899
2016,광주광역시,1469214,728137,741077,206874,21469
2016,대전광역시,1514370,757289,757081,2830857,94668
2016,대전광역시,1514370,757289,757081,1174034,85333
2016,대전광역시,1514370,757289,757081,761054,36932
2016,대전광역시,1514370,757289,757081,958072,52941
2016,대전광역시,1514370,757289,757081,494547,29127
2016,대전광역시,1514370,757289,757081,474193,26238
2016,대전광역시,1514370,757289,757081,361273,20965
2016,대전광역시,1514370,757289,757081,86607,10115
2016,대전광역시,1514370,757289,757081,3814834,167830
2016,대전광역시,1514370,757289,757081,575967,55709
2016,대전광역시,1514370,757289,757081,568567,56014
2016,대전광역시,1514370,757289,757081,776746,80152
2016,대전광역시,1514370,757289,757081,692563,73696
2016,대전광역시,1514370,757289,757081,755044,102257
2016,대전광역시,1514370,757289,757081,1009941,107862
2016,대전광역시,1514370,757289,757081,1151057,98899
2016,대전광역시,1514370,757289,757081,206874,21469
2016,울산광역시,1172304,603797,568507,2830857,94668
2016,울산광역시,1172304,603797,568507,1174034,85333
2016,울산광역시,1172304,603797,568507,761054,36932
2016,울산광역시,1172304,603797,568507,958072,52941
2016,울산광역시,1172304,603797,568507,494547,29127
2016,울산광역시,1172304,603797,568507,474193,26238
2016,울산광역시,1172304,603797,568507,361273,20965
2016,울산광역시,1172304,603797,568507,86607,10115
2016,울산광역시,1172304,603797,568507,3814834,167830
2016,울산광역시,1172304,603797,568507,575967,55709
2016,울산광역시,1172304,603797,568507,568567,56014
2016,울산광역시,1172304,603797,568507,776746,80152
2016,울산광역시,1172304,603797,568507,692563,73696
2016,울산광역시,1172304,603797,568507,755044,102257
2016,울산광역시,1172304,603797,568507,1009941,107862
2016,울산광역시,1172304,603797,568507,1151057,98899
2016,울산광역시,1172304,603797,568507,206874,21469
2016,세종특별자치시,243048,121505,121543,2830857,94668
2016,세종특별자치시,243048,121505,121543,1174034,85333
2016,세종특별자치시,243048,121505,121543,761054,36932
2016,세종특별자치시,243048,121505,121543,958072,52941
2016,세종특별자치시,243048,121505,121543,494547,29127
2016,세종특별자치시,243048,121505,121543,474193,26238
2016,세종특별자치시,243048,121505,121543,361273,20965
2016,세종특별자치시,243048,121505,121543,86607,10115
2016,세종특별자치시,243048,121505,121543,3814834,167830
2016,세종특별자치시,243048,121505,121543,575967,55709
2016,세종특별자치시,243048,121505,121543,568567,56014
2016,세종특별자치시,243048,121505,121543,776746,80152
2016,세종특별자치시,243048,121505,121543,692563,73696
2016,세종특별자치시,243048,121505,121543,755044,102257
2016,세종특별자치시,243048,121505,121543,1009941,107862
2016,세종특별자치시,243048,121505,121543,1151057,98899
2016,세종특별자치시,243048,121505,121543,206874,21469
2016,경기도,12716780,6395453,6321327,2830857,94668
2016,경기도,12716780,6395453,6321327,1174034,85333
2016,경기도,12716780,6395453,6321327,761054,36932
2016,경기도,12716780,6395453,6321327,958072,52941
2016,경기도,12716780,6395453,6321327,494547,29127
2016,경기도,12716780,6395453,6321327,474193,26238
2016,경기도,12716780,6395453,6321327,361273,20965
2016,경기도,12716780,6395453,6321327,86607,10115
2016,경기도,12716780,6395453,6321327,3814834,167830
2016,경기도,12716780,6395453,6321327,575967,55709
2016,경기도,12716780,6395453,6321327,568567,56014
2016,경기도,12716780,6395453,6321327,776746,80152
2016,경기도,12716780,6395453,6321327,692563,73696
2016,경기도,12716780,6395453,6321327,755044,102257
2016,경기도,12716780,6395453,6321327,1009941,107862
2016,경기도,12716780,6395453,6321327,1151057,98899
2016,경기도,12716780,6395453,6321327,206874,21469
2016,강원도,1550806,781146,769660,2830857,94668
2016,강원도,1550806,781146,769660,1174034,85333
2016,강원도,1550806,781146,769660,761054,36932
2016,강원도,1550806,781146,769660,958072,52941
2016,강원도,1550806,781146,769660,494547,29127
2016,강원도,1550806,781146,769660,474193,26238
2016,강원도,1550806,781146,769660,361273,20965
2016,강원도,1550806,781146,769660,86607,10115
2016,강원도,1550806,781146,769660,3814834,167830
2016,강원도,1550806,781146,769660,575967,55709
2016,강원도,1550806,781146,769660,568567,56014
2016,강원도,1550806,781146,769660,776746,80152
2016,강원도,1550806,781146,769660,692563,73696
2016,강원도,1550806,781146,769660,755044,102257
2016,강원도,1550806,781146,769660,1009941,107862
2016,강원도,1550806,781146,769660,1151057,98899
2016,강원도,1550806,781146,769660,206874,21469
2016,충청북도,1591625,803240,788385,2830857,94668
2016,충청북도,1591625,803240,788385,1174034,85333
2016,충청북도,1591625,803240,788385,761054,36932
2016,충청북도,1591625,803240,788385,958072,52941
2016,충청북도,1591625,803240,788385,494547,29127
2016,충청북도,1591625,803240,788385,474193,26238
2016,충청북도,1591625,803240,788385,361273,20965
2016,충청북도,1591625,803240,788385,86607,10115
2016,충청북도,1591625,803240,788385,3814834,167830
2016,충청북도,1591625,803240,788385,575967,55709
2016,충청북도,1591625,803240,788385,568567,56014
2016,충청북도,1591625,803240,788385,776746,80152
2016,충청북도,1591625,803240,788385,692563,73696
2016,충청북도,1591625,803240,788385,755044,102257
2016,충청북도,1591625,803240,788385,1009941,107862
2016,충청북도,1591625,803240,788385,1151057,98899
2016,충청북도,1591625,803240,788385,206874,21469
2016,충청남도,2096727,1064765,1031962,2830857,94668
2016,충청남도,2096727,1064765,1031962,1174034,85333
2016,충청남도,2096727,1064765,1031962,761054,36932
2016,충청남도,2096727,1064765,1031962,958072,52941
2016,충청남도,2096727,1064765,1031962,494547,29127
2016,충청남도,2096727,1064765,1031962,474193,26238
2016,충청남도,2096727,1064765,1031962,361273,20965
2016,충청남도,2096727,1064765,1031962,86607,10115
2016,충청남도,2096727,1064765,1031962,3814834,167830
2016,충청남도,2096727,1064765,1031962,575967,55709
2016,충청남도,2096727,1064765,1031962,568567,56014
2016,충청남도,2096727,1064765,1031962,776746,80152
2016,충청남도,2096727,1064765,1031962,692563,73696
2016,충청남도,2096727,1064765,1031962,755044,102257
2016,충청남도,2096727,1064765,1031962,1009941,107862
2016,충청남도,2096727,1064765,1031962,1151057,98899
2016,충청남도,2096727,1064765,1031962,206874,21469
2016,전라북도,1864791,927505,937286,2830857,94668
2016,전라북도,1864791,927505,937286,1174034,85333
2016,전라북도,1864791,927505,937286,761054,36932
2016,전라북도,1864791,927505,937286,958072,52941
2016,전라북도,1864791,927505,937286,494547,29127
2016,전라북도,1864791,927505,937286,474193,26238
2016,전라북도,1864791,927505,937286,361273,20965
2016,전라북도,1864791,927505,937286,86607,10115
2016,전라북도,1864791,927505,937286,3814834,167830
2016,전라북도,1864791,927505,937286,575967,55709
2016,전라북도,1864791,927505,937286,568567,56014
2016,전라북도,1864791,927505,937286,776746,80152
2016,전라북도,1864791,927505,937286,692563,73696
2016,전라북도,1864791,927505,937286,755044,102257
2016,전라북도,1864791,927505,937286,1009941,107862
2016,전라북도,1864791,927505,937286,1151057,98899
2016,전라북도,1864791,927505,937286,206874,21469
2016,전라남도,1903914,951889,952025,2830857,94668
2016,전라남도,1903914,951889,952025,1174034,85333
2016,전라남도,1903914,951889,952025,761054,36932
2016,전라남도,1903914,951889,952025,958072,52941
2016,전라남도,1903914,951889,952025,494547,29127
2016,전라남도,1903914,951889,952025,474193,26238
2016,전라남도,1903914,951889,952025,361273,20965
2016,전라남도,1903914,951889,952025,86607,10115
2016,전라남도,1903914,951889,952025,3814834,167830
2016,전라남도,1903914,951889,952025,575967,55709
2016,전라남도,1903914,951889,952025,568567,56014
2016,전라남도,1903914,951889,952025,776746,80152
2016,전라남도,1903914,951889,952025,692563,73696
2016,전라남도,1903914,951889,952025,755044,102257
2016,전라남도,1903914,951889,952025,1009941,107862
2016,전라남도,1903914,951889,952025,1151057,98899
2016,전라남도,1903914,951889,952025,206874,21469
2016,경상북도,2700398,1356868,1343530,2830857,94668
2016,경상북도,2700398,1356868,1343530,1174034,85333
2016,경상북도,2700398,1356868,1343530,761054,36932
2016,경상북도,2700398,1356868,1343530,958072,52941
2016,경상북도,2700398,1356868,1343530,494547,29127
2016,경상북도,2700398,1356868,1343530,474193,26238
2016,경상북도,2700398,1356868,1343530,361273,20965
2016,경상북도,2700398,1356868,1343530,86607,10115
2016,경상북도,2700398,1356868,1343530,3814834,167830
2016,경상북도,2700398,1356868,1343530,575967,55709
2016,경상북도,2700398,1356868,1343530,568567,56014
2016,경상북도,2700398,1356868,1343530,776746,80152
2016,경상북도,2700398,1356868,1343530,692563,73696
2016,경상북도,2700398,1356868,1343530,755044,102257
2016,경상북도,2700398,1356868,1343530,1009941,107862
2016,경상북도,2700398,1356868,1343530,1151057,98899
2016,경상북도,2700398,1356868,1343530,206874,21469
2016,경상남도,3373871,1699219,1674652,2830857,94668
2016,경상남도,3373871,1699219,1674652,1174034,85333
2016,경상남도,3373871,1699219,1674652,761054,36932
2016,경상남도,3373871,1699219,1674652,958072,52941
2016,경상남도,3373871,1699219,1674652,494547,29127
2016,경상남도,3373871,1699219,1674652,474193,26238
2016,경상남도,3373871,1699219,1674652,361273,20965
2016,경상남도,3373871,1699219,1674652,86607,10115
2016,경상남도,3373871,1699219,1674652,3814834,167830
2016,경상남도,3373871,1699219,1674652,575967,55709
2016,경상남도,3373871,1699219,1674652,568567,56014
2016,경상남도,3373871,1699219,1674652,776746,80152
2016,경상남도,3373871,1699219,1674652,692563,73696
2016,경상남도,3373871,1699219,1674652,755044,102257
2016,경상남도,3373871,1699219,1674652,1009941,107862
2016,경상남도,3373871,1699219,1674652,1151057,98899
2016,경상남도,3373871,1699219,1674652,206874,21469
2016,제주특별자치도,641597,322545,319052,2830857,94668
2016,제주특별자치도,641597,322545,319052,1174034,85333
2016,제주특별자치도,641597,322545,319052,761054,36932
2016,제주특별자치도,641597,322545,319052,958072,52941
2016,제주특별자치도,641597,322545,319052,494547,29127
2016,제주특별자치도,641597,322545,319052,474193,26238
2016,제주특별자치도,641597,322545,319052,361273,20965
2016,제주특별자치도,641597,322545,319052,86607,10115
2016,제주특별자치도,641597,322545,319052,3814834,167830
2016,제주특별자치도,641597,322545,319052,575967,55709
2016,제주특별자치도,641597,322545,319052,568567,56014
2016,제주특별자치도,641597,322545,319052,776746,80152
2016,제주특별자치도,641597,322545,319052,692563,73696
2016,제주특별자치도,641597,322545,319052,755044,102257
2016,제주특별자치도,641597,322545,319052,1009941,107862
2016,제주특별자치도,641597,322545,319052,1151057,98899
2016,제주특별자치도,641597,322545,319052,206874,21469
2017,서울특별시,9857426,4830206,5027220,2866845,93343
2017,서울특별시,9857426,4830206,5027220,1200422,94737
2017,서울특별시,9857426,4830206,5027220,783895,44180
2017,서울특별시,9857426,4830206,5027220,969588,57489
2017,서울특별시,9857426,4830206,5027220,505471,33569
2017,서울특별시,9857426,4830206,5027220,479161,26994
2017,서울특별시,9857426,4830206,5027220,371300,26867
2017,서울특별시,9857426,4830206,5027220,104448,14360
2017,서울특별시,9857426,4830206,5027220,3949829,194981
2017,서울특별시,9857426,4830206,5027220,586383,62109
2017,서울특별시,9857426,4830206,5027220,581855,60881
2017,서울특별시,9857426,4830206,5027220,805555,92110
2017,서울특별시,9857426,4830206,5027220,698264,77631
2017,서울특별시,9857426,4830206,5027220,766231,109799
2017,서울특별시,9857426,4830206,5027220,1038274,126480
2017,서울특별시,9857426,4830206,5027220,1193912,120548
2017,서울특별시,9857426,4830206,5027220,221140,28629
2017,부산광역시,3470653,1709508,1761145,2866845,93343
2017,부산광역시,3470653,1709508,1761145,1200422,94737
2017,부산광역시,3470653,1709508,1761145,783895,44180
2017,부산광역시,3470653,1709508,1761145,969588,57489
2017,부산광역시,3470653,1709508,1761145,505471,33569
2017,부산광역시,3470653,1709508,1761145,479161,26994
2017,부산광역시,3470653,1709508,1761145,371300,26867
2017,부산광역시,3470653,1709508,1761145,104448,14360
2017,부산광역시,3470653,1709508,1761145,3949829,194981
2017,부산광역시,3470653,1709508,1761145,586383,62109
2017,부산광역시,3470653,1709508,1761145,581855,60881
2017,부산광역시,3470653,1709508,1761145,805555,92110
2017,부산광역시,3470653,1709508,1761145,698264,77631
2017,부산광역시,3470653,1709508,1761145,766231,109799
2017,부산광역시,3470653,1709508,1761145,1038274,126480
2017,부산광역시,3470653,1709508,1761145,1193912,120548
2017,부산광역시,3470653,1709508,1761145,221140,28629
2017,대구광역시,2475231,1227814,1247417,2866845,93343
2017,대구광역시,2475231,1227814,1247417,1200422,94737
2017,대구광역시,2475231,1227814,1247417,783895,44180
2017,대구광역시,2475231,1227814,1247417,969588,57489
2017,대구광역시,2475231,1227814,1247417,505471,33569
2017,대구광역시,2475231,1227814,1247417,479161,26994
2017,대구광역시,2475231,1227814,1247417,371300,26867
2017,대구광역시,2475231,1227814,1247417,104448,14360
2017,대구광역시,2475231,1227814,1247417,3949829,194981
2017,대구광역시,2475231,1227814,1247417,586383,62109
2017,대구광역시,2475231,1227814,1247417,581855,60881
2017,대구광역시,2475231,1227814,1247417,805555,92110
2017,대구광역시,2475231,1227814,1247417,698264,77631
2017,대구광역시,2475231,1227814,1247417,766231,109799
2017,대구광역시,2475231,1227814,1247417,1038274,126480
2017,대구광역시,2475231,1227814,1247417,1193912,120548
2017,대구광역시,2475231,1227814,1247417,221140,28629
2017,인천광역시,2948542,1479597,1468945,2866845,93343
2017,인천광역시,2948542,1479597,1468945,1200422,94737
2017,인천광역시,2948542,1479597,1468945,783895,44180
2017,인천광역시,2948542,1479597,1468945,969588,57489
2017,인천광역시,2948542,1479597,1468945,505471,33569
2017,인천광역시,2948542,1479597,1468945,479161,26994
2017,인천광역시,2948542,1479597,1468945,371300,26867
2017,인천광역시,2948542,1479597,1468945,104448,14360
2017,인천광역시,2948542,1479597,1468945,3949829,194981
2017,인천광역시,2948542,1479597,1468945,586383,62109
2017,인천광역시,2948542,1479597,1468945,581855,60881
2017,인천광역시,2948542,1479597,1468945,805555,92110
2017,인천광역시,2948542,1479597,1468945,698264,77631
2017,인천광역시,2948542,1479597,1468945,766231,109799
2017,인천광역시,2948542,1479597,1468945,1038274,126480
2017,인천광역시,2948542,1479597,1468945,1193912,120548
2017,인천광역시,2948542,1479597,1468945,221140,28629
2017,광주광역시,1463770,725295,738475,2866845,93343
2017,광주광역시,1463770,725295,738475,1200422,94737
2017,광주광역시,1463770,725295,738475,783895,44180
2017,광주광역시,1463770,725295,738475,969588,57489
2017,광주광역시,1463770,725295,738475,505471,33569
2017,광주광역시,1463770,725295,738475,479161,26994
2017,광주광역시,1463770,725295,738475,371300,26867
2017,광주광역시,1463770,725295,738475,104448,14360
2017,광주광역시,1463770,725295,738475,3949829,194981
2017,광주광역시,1463770,725295,738475,586383,62109
2017,광주광역시,1463770,725295,738475,581855,60881
2017,광주광역시,1463770,725295,738475,805555,92110
2017,광주광역시,1463770,725295,738475,698264,77631
2017,광주광역시,1463770,725295,738475,766231,109799
2017,광주광역시,1463770,725295,738475,1038274,126480
2017,광주광역시,1463770,725295,738475,1193912,120548
2017,광주광역시,1463770,725295,738475,221140,28629
2017,대전광역시,1502227,750969,751258,2866845,93343
2017,대전광역시,1502227,750969,751258,1200422,94737
2017,대전광역시,1502227,750969,751258,783895,44180
2017,대전광역시,1502227,750969,751258,969588,57489
2017,대전광역시,1502227,750969,751258,505471,33569
2017,대전광역시,1502227,750969,751258,479161,26994
2017,대전광역시,1502227,750969,751258,371300,26867
2017,대전광역시,1502227,750969,751258,104448,14360
2017,대전광역시,1502227,750969,751258,3949829,194981
2017,대전광역시,1502227,750969,751258,586383,62109
2017,대전광역시,1502227,750969,751258,581855,60881
2017,대전광역시,1502227,750969,751258,805555,92110
2017,대전광역시,1502227,750969,751258,698264,77631
2017,대전광역시,1502227,750969,751258,766231,109799
2017,대전광역시,1502227,750969,751258,1038274,126480
2017,대전광역시,1502227,750969,751258,1193912,120548
2017,대전광역시,1502227,750969,751258,221140,28629
2017,울산광역시,1165132,599480,565652,2866845,93343
2017,울산광역시,1165132,599480,565652,1200422,94737
2017,울산광역시,1165132,599480,565652,783895,44180
2017,울산광역시,1165132,599480,565652,969588,57489
2017,울산광역시,1165132,599480,565652,505471,33569
2017,울산광역시,1165132,599480,565652,479161,26994
2017,울산광역시,1165132,599480,565652,371300,26867
2017,울산광역시,1165132,599480,565652,104448,14360
2017,울산광역시,1165132,599480,565652,3949829,194981
2017,울산광역시,1165132,599480,565652,586383,62109
2017,울산광역시,1165132,599480,565652,581855,60881
2017,울산광역시,1165132,599480,565652,805555,92110
2017,울산광역시,1165132,599480,565652,698264,77631
2017,울산광역시,1165132,599480,565652,766231,109799
2017,울산광역시,1165132,599480,565652,1038274,126480
2017,울산광역시,1165132,599480,565652,1193912,120548
2017,울산광역시,1165132,599480,565652,221140,28629
2017,세종특별자치시,280100,139734,140366,2866845,93343
2017,세종특별자치시,280100,139734,140366,1200422,94737
2017,세종특별자치시,280100,139734,140366,783895,44180
2017,세종특별자치시,280100,139734,140366,969588,57489
2017,세종특별자치시,280100,139734,140366,505471,33569
2017,세종특별자치시,280100,139734,140366,479161,26994
2017,세종특별자치시,280100,139734,140366,371300,26867
2017,세종특별자치시,280100,139734,140366,104448,14360
2017,세종특별자치시,280100,139734,140366,3949829,194981
2017,세종특별자치시,280100,139734,140366,586383,62109
2017,세종특별자치시,280100,139734,140366,581855,60881
2017,세종특별자치시,280100,139734,140366,805555,92110
2017,세종특별자치시,280100,139734,140366,698264,77631
2017,세종특별자치시,280100,139734,140366,766231,109799
2017,세종특별자치시,280100,139734,140366,1038274,126480
2017,세종특별자치시,280100,139734,140366,1193912,120548
2017,세종특별자치시,280100,139734,140366,221140,28629
2017,경기도,12873895,6475323,6398572,2866845,93343
2017,경기도,12873895,6475323,6398572,1200422,94737
2017,경기도,12873895,6475323,6398572,783895,44180
2017,경기도,12873895,6475323,6398572,969588,57489
2017,경기도,12873895,6475323,6398572,505471,33569
2017,경기도,12873895,6475323,6398572,479161,26994
2017,경기도,12873895,6475323,6398572,371300,26867
2017,경기도,12873895,6475323,6398572,104448,14360
2017,경기도,12873895,6475323,6398572,3949829,194981
2017,경기도,12873895,6475323,6398572,586383,62109
2017,경기도,12873895,6475323,6398572,581855,60881
2017,경기도,12873895,6475323,6398572,805555,92110
2017,경기도,12873895,6475323,6398572,698264,77631
2017,경기도,12873895,6475323,6398572,766231,109799
2017,경기도,12873895,6475323,6398572,1038274,126480
2017,경기도,12873895,6475323,6398572,1193912,120548
2017,경기도,12873895,6475323,6398572,221140,28629
2017,강원도,1550142,780635,769507,2866845,93343
2017,강원도,1550142,780635,769507,1200422,94737
2017,강원도,1550142,780635,769507,783895,44180
2017,강원도,1550142,780635,769507,969588,57489
2017,강원도,1550142,780635,769507,505471,33569
2017,강원도,1550142,780635,769507,479161,26994
2017,강원도,1550142,780635,769507,371300,26867
2017,강원도,1550142,780635,769507,104448,14360
2017,강원도,1550142,780635,769507,3949829,194981
2017,강원도,1550142,780635,769507,586383,62109
2017,강원도,1550142,780635,769507,581855,60881
2017,강원도,1550142,780635,769507,805555,92110
2017,강원도,1550142,780635,769507,698264,77631
2017,강원도,1550142,780635,769507,766231,109799
2017,강원도,1550142,780635,769507,1038274,126480
2017,강원도,1550142,780635,769507,1193912,120548
2017,강원도,1550142,780635,769507,221140,28629
2017,충청북도,1594432,805091,789341,2866845,93343
2017,충청북도,1594432,805091,789341,1200422,94737
2017,충청북도,1594432,805091,789341,783895,44180
2017,충청북도,1594432,805091,789341,969588,57489
2017,충청북도,1594432,805091,789341,505471,33569
2017,충청북도,1594432,805091,789341,479161,26994
2017,충청북도,1594432,805091,789341,371300,26867
2017,충청북도,1594432,805091,789341,104448,14360
2017,충청북도,1594432,805091,789341,3949829,194981
2017,충청북도,1594432,805091,789341,586383,62109
2017,충청북도,1594432,805091,789341,581855,60881
2017,충청북도,1594432,805091,789341,805555,92110
2017,충청북도,1594432,805091,789341,698264,77631
2017,충청북도,1594432,805091,789341,766231,109799
2017,충청북도,1594432,805091,789341,1038274,126480
2017,충청북도,1594432,805091,789341,1193912,120548
2017,충청북도,1594432,805091,789341,221140,28629
2017,충청남도,2116770,1076270,1040500,2866845,93343
2017,충청남도,2116770,1076270,1040500,1200422,94737
2017,충청남도,2116770,1076270,1040500,783895,44180
2017,충청남도,2116770,1076270,1040500,969588,57489
2017,충청남도,2116770,1076270,1040500,505471,33569
2017,충청남도,2116770,1076270,1040500,479161,26994
2017,충청남도,2116770,1076270,1040500,371300,26867
2017,충청남도,2116770,1076270,1040500,104448,14360
2017,충청남도,2116770,1076270,1040500,3949829,194981
2017,충청남도,2116770,1076270,1040500,586383,62109
2017,충청남도,2116770,1076270,1040500,581855,60881
2017,충청남도,2116770,1076270,1040500,805555,92110
2017,충청남도,2116770,1076270,1040500,698264,77631
2017,충청남도,2116770,1076270,1040500,766231,109799
2017,충청남도,2116770,1076270,1040500,1038274,126480
2017,충청남도,2116770,1076270,1040500,1193912,120548
2017,충청남도,2116770,1076270,1040500,221140,28629
2017,전라북도,1854607,922307,932300,2866845,93343
2017,전라북도,1854607,922307,932300,1200422,94737
2017,전라북도,1854607,922307,932300,783895,44180
2017,전라북도,1854607,922307,932300,969588,57489
2017,전라북도,1854607,922307,932300,505471,33569
2017,전라북도,1854607,922307,932300,479161,26994
2017,전라북도,1854607,922307,932300,371300,26867
2017,전라북도,1854607,922307,932300,104448,14360
2017,전라북도,1854607,922307,932300,3949829,194981
2017,전라북도,1854607,922307,932300,586383,62109
2017,전라북도,1854607,922307,932300,581855,60881
2017,전라북도,1854607,922307,932300,805555,92110
2017,전라북도,1854607,922307,932300,698264,77631
2017,전라북도,1854607,922307,932300,766231,109799
2017,전라북도,1854607,922307,932300,1038274,126480
2017,전라북도,1854607,922307,932300,1193912,120548
2017,전라북도,1854607,922307,932300,221140,28629
2017,전라남도,1896424,948290,948134,2866845,93343
2017,전라남도,1896424,948290,948134,1200422,94737
2017,전라남도,1896424,948290,948134,783895,44180
2017,전라남도,1896424,948290,948134,969588,57489
2017,전라남도,1896424,948290,948134,505471,33569
2017,전라남도,1896424,948290,948134,479161,26994
2017,전라남도,1896424,948290,948134,371300,26867
2017,전라남도,1896424,948290,948134,104448,14360
2017,전라남도,1896424,948290,948134,3949829,194981
2017,전라남도,1896424,948290,948134,586383,62109
2017,전라남도,1896424,948290,948134,581855,60881
2017,전라남도,1896424,948290,948134,805555,92110
2017,전라남도,1896424,948290,948134,698264,77631
2017,전라남도,1896424,948290,948134,766231,109799
2017,전라남도,1896424,948290,948134,1038274,126480
2017,전라남도,1896424,948290,948134,1193912,120548
2017,전라남도,1896424,948290,948134,221140,28629
2017,경상북도,2691706,1353164,1338542,2866845,93343
2017,경상북도,2691706,1353164,1338542,1200422,94737
2017,경상북도,2691706,1353164,1338542,783895,44180
2017,경상북도,2691706,1353164,1338542,969588,57489
2017,경상북도,2691706,1353164,1338542,505471,33569
2017,경상북도,2691706,1353164,1338542,479161,26994
2017,경상북도,2691706,1353164,1338542,371300,26867
2017,경상북도,2691706,1353164,1338542,104448,14360
2017,경상북도,2691706,1353164,1338542,3949829,194981
2017,경상북도,2691706,1353164,1338542,586383,62109
2017,경상북도,2691706,1353164,1338542,581855,60881
2017,경상북도,2691706,1353164,1338542,805555,92110
2017,경상북도,2691706,1353164,1338542,698264,77631
2017,경상북도,2691706,1353164,1338542,766231,109799
2017,경상북도,2691706,1353164,1338542,1038274,126480
2017,경상북도,2691706,1353164,1338542,1193912,120548
2017,경상북도,2691706,1353164,1338542,221140,28629
2017,경상남도,3380404,1701413,1678991,2866845,93343
2017,경상남도,3380404,1701413,1678991,1200422,94737
2017,경상남도,3380404,1701413,1678991,783895,44180
2017,경상남도,3380404,1701413,1678991,969588,57489
2017,경상남도,3380404,1701413,1678991,505471,33569
2017,경상남도,3380404,1701413,1678991,479161,26994
2017,경상남도,3380404,1701413,1678991,371300,26867
2017,경상남도,3380404,1701413,1678991,104448,14360
2017,경상남도,3380404,1701413,1678991,3949829,194981
2017,경상남도,3380404,1701413,1678991,586383,62109
2017,경상남도,3380404,1701413,1678991,581855,60881
2017,경상남도,3380404,1701413,1678991,805555,92110
2017,경상남도,3380404,1701413,1678991,698264,77631
2017,경상남도,3380404,1701413,1678991,766231,109799
2017,경상남도,3380404,1701413,1678991,1038274,126480
2017,경상남도,3380404,1701413,1678991,1193912,120548
2017,경상남도,3380404,1701413,1678991,221140,28629
2017,제주특별자치도,657083,330823,326260,2866845,93343
2017,제주특별자치도,657083,330823,326260,1200422,94737
2017,제주특별자치도,657083,330823,326260,783895,44180
2017,제주특별자치도,657083,330823,326260,969588,57489
2017,제주특별자치도,657083,330823,326260,505471,33569
2017,제주특별자치도,657083,330823,326260,479161,26994
2017,제주특별자치도,657083,330823,326260,371300,26867
2017,제주특별자치도,657083,330823,326260,104448,14360
2017,제주특별자치도,657083,330823,326260,3949829,194981
2017,제주특별자치도,657083,330823,326260,586383,62109
2017,제주특별자치도,657083,330823,326260,581855,60881
2017,제주특별자치도,657083,330823,326260,805555,92110
2017,제주특별자치도,657083,330823,326260,698264,77631
2017,제주특별자치도,657083,330823,326260,766231,109799
2017,제주특별자치도,657083,330823,326260,1038274,126480
2017,제주특별자치도,657083,330823,326260,1193912,120548
2017,제주특별자치도,657083,330823,326260,221140,28629
2018,서울특별시,9765623,4773899,4991724,2894078,93867
2018,서울특별시,9765623,4773899,4991724,1220782,99458
2018,서울특별시,9765623,4773899,4991724,792998,40861
2018,서울특별시,9765623,4773899,4991724,997959,64927
2018,서울특별시,9765623,4773899,4991724,514767,37220
2018,서울특별시,9765623,4773899,4991724,486764,29900
2018,서울특별시,9765623,4773899,4991724,379741,29265
2018,서울특별시,9765623,4773899,4991724,118959,14242
2018,서울특별시,9765623,4773899,4991724,4169100,249635
2018,서울특별시,9765623,4773899,4991724,603644,72384
2018,서울특별시,9765623,4773899,4991724,607686,74757
2018,서울특별시,9765623,4773899,4991724,835752,106443
2018,서울특별시,9765623,4773899,4991724,712850,86732
2018,서울특별시,9765623,4773899,4991724,777966,118648
2018,서울특별시,9765623,4773899,4991724,1060505,136805
2018,서울특별시,9765623,4773899,4991724,1226708,131870
2018,서울특별시,9765623,4773899,4991724,233068,32603
2018,부산광역시,3441453,1692421,1749032,2894078,93867
2018,부산광역시,3441453,1692421,1749032,1220782,99458
2018,부산광역시,3441453,1692421,1749032,792998,40861
2018,부산광역시,3441453,1692421,1749032,997959,64927
2018,부산광역시,3441453,1692421,1749032,514767,37220
2018,부산광역시,3441453,1692421,1749032,486764,29900
2018,부산광역시,3441453,1692421,1749032,379741,29265
2018,부산광역시,3441453,1692421,1749032,118959,14242
2018,부산광역시,3441453,1692421,1749032,4169100,249635
2018,부산광역시,3441453,1692421,1749032,603644,72384
2018,부산광역시,3441453,1692421,1749032,607686,74757
2018,부산광역시,3441453,1692421,1749032,835752,106443
2018,부산광역시,3441453,1692421,1749032,712850,86732
2018,부산광역시,3441453,1692421,1749032,777966,118648
2018,부산광역시,3441453,1692421,1749032,1060505,136805
2018,부산광역시,3441453,1692421,1749032,1226708,131870
2018,부산광역시,3441453,1692421,1749032,233068,32603
2018,대구광역시,2461769,1219342,1242427,2894078,93867
2018,대구광역시,2461769,1219342,1242427,1220782,99458
2018,대구광역시,2461769,1219342,1242427,792998,40861
2018,대구광역시,2461769,1219342,1242427,997959,64927
2018,대구광역시,2461769,1219342,1242427,514767,37220
2018,대구광역시,2461769,1219342,1242427,486764,29900
2018,대구광역시,2461769,1219342,1242427,379741,29265
2018,대구광역시,2461769,1219342,1242427,118959,14242
2018,대구광역시,2461769,1219342,1242427,4169100,249635
2018,대구광역시,2461769,1219342,1242427,603644,72384
2018,대구광역시,2461769,1219342,1242427,607686,74757
2018,대구광역시,2461769,1219342,1242427,835752,106443
2018,대구광역시,2461769,1219342,1242427,712850,86732
2018,대구광역시,2461769,1219342,1242427,777966,118648
2018,대구광역시,2461769,1219342,1242427,1060505,136805
2018,대구광역시,2461769,1219342,1242427,1226708,131870
2018,대구광역시,2461769,1219342,1242427,233068,32603
2018,인천광역시,2954642,1481844,1472798,2894078,93867
2018,인천광역시,2954642,1481844,1472798,1220782,99458
2018,인천광역시,2954642,1481844,1472798,792998,40861
2018,인천광역시,2954642,1481844,1472798,997959,64927
2018,인천광역시,2954642,1481844,1472798,514767,37220
2018,인천광역시,2954642,1481844,1472798,486764,29900
2018,인천광역시,2954642,1481844,1472798,379741,29265
2018,인천광역시,2954642,1481844,1472798,118959,14242
2018,인천광역시,2954642,1481844,1472798,4169100,249635
2018,인천광역시,2954642,1481844,1472798,603644,72384
2018,인천광역시,2954642,1481844,1472798,607686,74757
2018,인천광역시,2954642,1481844,1472798,835752,106443
2018,인천광역시,2954642,1481844,1472798,712850,86732
2018,인천광역시,2954642,1481844,1472798,777966,118648
2018,인천광역시,2954642,1481844,1472798,1060505,136805
2018,인천광역시,2954642,1481844,1472798,1226708,131870
2018,인천광역시,2954642,1481844,1472798,233068,32603
2018,광주광역시,1459336,722581,736755,2894078,93867
2018,광주광역시,1459336,722581,736755,1220782,99458
2018,광주광역시,1459336,722581,736755,792998,40861
2018,광주광역시,1459336,722581,736755,997959,64927
2018,광주광역시,1459336,722581,736755,514767,37220
2018,광주광역시,1459336,722581,736755,486764,29900
2018,광주광역시,1459336,722581,736755,379741,29265
2018,광주광역시,1459336,722581,736755,118959,14242
2018,광주광역시,1459336,722581,736755,4169100,249635
2018,광주광역시,1459336,722581,736755,603644,72384
2018,광주광역시,1459336,722581,736755,607686,74757
2018,광주광역시,1459336,722581,736755,835752,106443
2018,광주광역시,1459336,722581,736755,712850,86732
2018,광주광역시,1459336,722581,736755,777966,118648
2018,광주광역시,1459336,722581,736755,1060505,136805
2018,광주광역시,1459336,722581,736755,1226708,131870
2018,광주광역시,1459336,722581,736755,233068,32603
2018,대전광역시,1489936,744338,745598,2894078,93867
2018,대전광역시,1489936,744338,745598,1220782,99458
2018,대전광역시,1489936,744338,745598,792998,40861
2018,대전광역시,1489936,744338,745598,997959,64927
2018,대전광역시,1489936,744338,745598,514767,37220
2018,대전광역시,1489936,744338,745598,486764,29900
2018,대전광역시,1489936,744338,745598,379741,29265
2018,대전광역시,1489936,744338,745598,118959,14242
2018,대전광역시,1489936,744338,745598,4169100,249635
2018,대전광역시,1489936,744338,745598,603644,72384
2018,대전광역시,1489936,744338,745598,607686,74757
2018,대전광역시,1489936,744338,745598,835752,106443
2018,대전광역시,1489936,744338,745598,712850,86732
2018,대전광역시,1489936,744338,745598,777966,118648
2018,대전광역시,1489936,744338,745598,1060505,136805
2018,대전광역시,1489936,744338,745598,1226708,131870
2018,대전광역시,1489936,744338,745598,233068,32603
2018,울산광역시,1155623,593819,561804,2894078,93867
2018,울산광역시,1155623,593819,561804,1220782,99458
2018,울산광역시,1155623,593819,561804,792998,40861
2018,울산광역시,1155623,593819,561804,997959,64927
2018,울산광역시,1155623,593819,561804,514767,37220
2018,울산광역시,1155623,593819,561804,486764,29900
2018,울산광역시,1155623,593819,561804,379741,29265
2018,울산광역시,1155623,593819,561804,118959,14242
2018,울산광역시,1155623,593819,561804,4169100,249635
2018,울산광역시,1155623,593819,561804,603644,72384
2018,울산광역시,1155623,593819,561804,607686,74757
2018,울산광역시,1155623,593819,561804,835752,106443
2018,울산광역시,1155623,593819,561804,712850,86732
2018,울산광역시,1155623,593819,561804,777966,118648
2018,울산광역시,1155623,593819,561804,1060505,136805
2018,울산광역시,1155623,593819,561804,1226708,131870
2018,울산광역시,1155623,593819,561804,233068,32603
2018,세종특별자치시,314126,156831,157295,2894078,93867
2018,세종특별자치시,314126,156831,157295,1220782,99458
2018,세종특별자치시,314126,156831,157295,792998,40861
2018,세종특별자치시,314126,156831,157295,997959,64927
2018,세종특별자치시,314126,156831,157295,514767,37220
2018,세종특별자치시,314126,156831,157295,486764,29900
2018,세종특별자치시,314126,156831,157295,379741,29265
2018,세종특별자치시,314126,156831,157295,118959,14242
2018,세종특별자치시,314126,156831,157295,4169100,249635
2018,세종특별자치시,314126,156831,157295,603644,72384
2018,세종특별자치시,314126,156831,157295,607686,74757
2018,세종특별자치시,314126,156831,157295,835752,106443
2018,세종특별자치시,314126,156831,157295,712850,86732
2018,세종특별자치시,314126,156831,157295,777966,118648
2018,세종특별자치시,314126,156831,157295,1060505,136805
2018,세종특별자치시,314126,156831,157295,1226708,131870
2018,세종특별자치시,314126,156831,157295,233068,32603
2018,경기도,13077153,6577501,6499652,2894078,93867
2018,경기도,13077153,6577501,6499652,1220782,99458
2018,경기도,13077153,6577501,6499652,792998,40861
2018,경기도,13077153,6577501,6499652,997959,64927
2018,경기도,13077153,6577501,6499652,514767,37220
2018,경기도,13077153,6577501,6499652,486764,29900
2018,경기도,13077153,6577501,6499652,379741,29265
2018,경기도,13077153,6577501,6499652,118959,14242
2018,경기도,13077153,6577501,6499652,4169100,249635
2018,경기도,13077153,6577501,6499652,603644,72384
2018,경기도,13077153,6577501,6499652,607686,74757
2018,경기도,13077153,6577501,6499652,835752,106443
2018,경기도,13077153,6577501,6499652,712850,86732
2018,경기도,13077153,6577501,6499652,777966,118648
2018,경기도,13077153,6577501,6499652,1060505,136805
2018,경기도,13077153,6577501,6499652,1226708,131870
2018,경기도,13077153,6577501,6499652,233068,32603
2018,강원도,1543052,776456,766596,2894078,93867
2018,강원도,1543052,776456,766596,1220782,99458
2018,강원도,1543052,776456,766596,792998,40861
2018,강원도,1543052,776456,766596,997959,64927
2018,강원도,1543052,776456,766596,514767,37220
2018,강원도,1543052,776456,766596,486764,29900
2018,강원도,1543052,776456,766596,379741,29265
2018,강원도,1543052,776456,766596,118959,14242
2018,강원도,1543052,776456,766596,4169100,249635
2018,강원도,1543052,776456,766596,603644,72384
2018,강원도,1543052,776456,766596,607686,74757
2018,강원도,1543052,776456,766596,835752,106443
2018,강원도,1543052,776456,766596,712850,86732
2018,강원도,1543052,776456,766596,777966,118648
2018,강원도,1543052,776456,766596,1060505,136805
2018,강원도,1543052,776456,766596,1226708,131870
2018,강원도,1543052,776456,766596,233068,32603
2018,충청북도,1599252,808971,790281,2894078,93867
2018,충청북도,1599252,808971,790281,1220782,99458
2018,충청북도,1599252,808971,790281,792998,40861
2018,충청북도,1599252,808971,790281,997959,64927
2018,충청북도,1599252,808971,790281,514767,37220
2018,충청북도,1599252,808971,790281,486764,29900
2018,충청북도,1599252,808971,790281,379741,29265
2018,충청북도,1599252,808971,790281,118959,14242
2018,충청북도,1599252,808971,790281,4169100,249635
2018,충청북도,1599252,808971,790281,603644,72384
2018,충청북도,1599252,808971,790281,607686,74757
2018,충청북도,1599252,808971,790281,835752,106443
2018,충청북도,1599252,808971,790281,712850,86732
2018,충청북도,1599252,808971,790281,777966,118648
2018,충청북도,1599252,808971,790281,1060505,136805
2018,충청북도,1599252,808971,790281,1226708,131870
2018,충청북도,1599252,808971,790281,233068,32603
2018,충청남도,2126282,1082009,1044273,2894078,93867
2018,충청남도,2126282,1082009,1044273,1220782,99458
2018,충청남도,2126282,1082009,1044273,792998,40861
2018,충청남도,2126282,1082009,1044273,997959,64927
2018,충청남도,2126282,1082009,1044273,514767,37220
2018,충청남도,2126282,1082009,1044273,486764,29900
2018,충청남도,2126282,1082009,1044273,379741,29265
2018,충청남도,2126282,1082009,1044273,118959,14242
2018,충청남도,2126282,1082009,1044273,4169100,249635
2018,충청남도,2126282,1082009,1044273,603644,72384
2018,충청남도,2126282,1082009,1044273,607686,74757
2018,충청남도,2126282,1082009,1044273,835752,106443
2018,충청남도,2126282,1082009,1044273,712850,86732
2018,충청남도,2126282,1082009,1044273,777966,118648
2018,충청남도,2126282,1082009,1044273,1060505,136805
2018,충청남도,2126282,1082009,1044273,1226708,131870
2018,충청남도,2126282,1082009,1044273,233068,32603
2018,전라북도,1836832,913297,923535,2894078,93867
2018,전라북도,1836832,913297,923535,1220782,99458
2018,전라북도,1836832,913297,923535,792998,40861
2018,전라북도,1836832,913297,923535,997959,64927
2018,전라북도,1836832,913297,923535,514767,37220
2018,전라북도,1836832,913297,923535,486764,29900
2018,전라북도,1836832,913297,923535,379741,29265
2018,전라북도,1836832,913297,923535,118959,14242
2018,전라북도,1836832,913297,923535,4169100,249635
2018,전라북도,1836832,913297,923535,603644,72384
2018,전라북도,1836832,913297,923535,607686,74757
2018,전라북도,1836832,913297,923535,835752,106443
2018,전라북도,1836832,913297,923535,712850,86732
2018,전라북도,1836832,913297,923535,777966,118648
2018,전라북도,1836832,913297,923535,1060505,136805
2018,전라북도,1836832,913297,923535,1226708,131870
2018,전라북도,1836832,913297,923535,233068,32603
2018,전라남도,1882970,943000,939970,2894078,93867
2018,전라남도,1882970,943000,939970,1220782,99458
2018,전라남도,1882970,943000,939970,792998,40861
2018,전라남도,1882970,943000,939970,997959,64927
2018,전라남도,1882970,943000,939970,514767,37220
2018,전라남도,1882970,943000,939970,486764,29900
2018,전라남도,1882970,943000,939970,379741,29265
2018,전라남도,1882970,943000,939970,118959,14242
2018,전라남도,1882970,943000,939970,4169100,249635
2018,전라남도,1882970,943000,939970,603644,72384
2018,전라남도,1882970,943000,939970,607686,74757
2018,전라남도,1882970,943000,939970,835752,106443
2018,전라남도,1882970,943000,939970,712850,86732
2018,전라남도,1882970,943000,939970,777966,118648
2018,전라남도,1882970,943000,939970,1060505,136805
2018,전라남도,1882970,943000,939970,1226708,131870
2018,전라남도,1882970,943000,939970,233068,32603
2018,경상북도,2676831,1346689,1330142,2894078,93867
2018,경상북도,2676831,1346689,1330142,1220782,99458
2018,경상북도,2676831,1346689,1330142,792998,40861
2018,경상북도,2676831,1346689,1330142,997959,64927
2018,경상북도,2676831,1346689,1330142,514767,37220
2018,경상북도,2676831,1346689,1330142,486764,29900
2018,경상북도,2676831,1346689,1330142,379741,29265
2018,경상북도,2676831,1346689,1330142,118959,14242
2018,경상북도,2676831,1346689,1330142,4169100,249635
2018,경상북도,2676831,1346689,1330142,603644,72384
2018,경상북도,2676831,1346689,1330142,607686,74757
2018,경상북도,2676831,1346689,1330142,835752,106443
2018,경상북도,2676831,1346689,1330142,712850,86732
2018,경상북도,2676831,1346689,1330142,777966,118648
2018,경상북도,2676831,1346689,1330142,1060505,136805
2018,경상북도,2676831,1346689,1330142,1226708,131870
2018,경상북도,2676831,1346689,1330142,233068,32603
2018,경상남도,3373988,1697412,1676576,2894078,93867
2018,경상남도,3373988,1697412,1676576,1220782,99458
2018,경상남도,3373988,1697412,1676576,792998,40861
2018,경상남도,3373988,1697412,1676576,997959,64927
2018,경상남도,3373988,1697412,1676576,514767,37220
2018,경상남도,3373988,1697412,1676576,486764,29900
2018,경상남도,3373988,1697412,1676576,379741,29265
2018,경상남도,3373988,1697412,1676576,118959,14242
2018,경상남도,3373988,1697412,1676576,4169100,249635
2018,경상남도,3373988,1697412,1676576,603644,72384
2018,경상남도,3373988,1697412,1676576,607686,74757
2018,경상남도,3373988,1697412,1676576,835752,106443
2018,경상남도,3373988,1697412,1676576,712850,86732
2018,경상남도,3373988,1697412,1676576,777966,118648
2018,경상남도,3373988,1697412,1676576,1060505,136805
2018,경상남도,3373988,1697412,1676576,1226708,131870
2018,경상남도,3373988,1697412,1676576,233068,32603
2018,제주특별자치도,667191,335719,331472,2894078,93867
2018,제주특별자치도,667191,335719,331472,1220782,99458
2018,제주특별자치도,667191,335719,331472,792998,40861
2018,제주특별자치도,667191,335719,331472,997959,64927
2018,제주특별자치도,667191,335719,331472,514767,37220
2018,제주특별자치도,667191,335719,331472,486764,29900
2018,제주특별자치도,667191,335719,331472,379741,29265
2018,제주특별자치도,667191,335719,331472,118959,14242
2018,제주특별자치도,667191,335719,331472,4169100,249635
2018,제주특별자치도,667191,335719,331472,603644,72384
2018,제주특별자치도,667191,335719,331472,607686,74757
2018,제주특별자치도,667191,335719,331472,835752,106443
2018,제주특별자치도,667191,335719,331472,712850,86732
2018,제주특별자치도,667191,335719,331472,777966,118648
2018,제주특별자치도,667191,335719,331472,1060505,136805
2018,제주특별자치도,667191,335719,331472,1226708,131870
2018,제주특별자치도,667191,335719,331472,233068,32603
2019,서울특별시,9729107,4744059,4985048,2953964,93402
2019,서울특별시,9729107,4744059,4985048,1249757,109651
2019,서울특별시,9729107,4744059,4985048,800340,40721
2019,서울특별시,9729107,4744059,4985048,1019365,66695
2019,서울특별시,9729107,4744059,4985048,526161,39625
2019,서울특별시,9729107,4744059,4985048,492797,29640
2019,서울특별시,9729107,4744059,4985048,391596,33114
2019,서울특별시,9729107,4744059,4985048,132257,16437
2019,서울특별시,9729107,4744059,4985048,4354776,278815
2019,서울특별시,9729107,4744059,4985048,627376,84382
2019,서울특별시,9729107,4744059,4985048,625957,77520
2019,서울특별시,9729107,4744059,4985048,850525,107609
2019,서울특별시,9729107,4744059,4985048,724524,91138
2019,서울특별시,9729107,4744059,4985048,787816,121767
2019,서울특별시,9729107,4744059,4985048,1081216,143560
2019,서울특별시,9729107,4744059,4985048,1266739,147173
2019,서울특별시,9729107,4744059,4985048,241788,36566
2019,부산광역시,3413841,1675417,1738424,2953964,93402
2019,부산광역시,3413841,1675417,1738424,1249757,109651
2019,부산광역시,3413841,1675417,1738424,800340,40721
2019,부산광역시,3413841,1675417,1738424,1019365,66695
2019,부산광역시,3413841,1675417,1738424,526161,39625
2019,부산광역시,3413841,1675417,1738424,492797,29640
2019,부산광역시,3413841,1675417,1738424,391596,33114
2019,부산광역시,3413841,1675417,1738424,132257,16437
2019,부산광역시,3413841,1675417,1738424,4354776,278815
2019,부산광역시,3413841,1675417,1738424,627376,84382
2019,부산광역시,3413841,1675417,1738424,625957,77520
2019,부산광역시,3413841,1675417,1738424,850525,107609
2019,부산광역시,3413841,1675417,1738424,724524,91138
2019,부산광역시,3413841,1675417,1738424,787816,121767
2019,부산광역시,3413841,1675417,1738424,1081216,143560
2019,부산광역시,3413841,1675417,1738424,1266739,147173
2019,부산광역시,3413841,1675417,1738424,241788,36566
2019,대구광역시,2438031,1205286,1232745,2953964,93402
2019,대구광역시,2438031,1205286,1232745,1249757,109651
2019,대구광역시,2438031,1205286,1232745,800340,40721
2019,대구광역시,2438031,1205286,1232745,1019365,66695
2019,대구광역시,2438031,1205286,1232745,526161,39625
2019,대구광역시,2438031,1205286,1232745,492797,29640
2019,대구광역시,2438031,1205286,1232745,391596,33114
2019,대구광역시,2438031,1205286,1232745,132257,16437
2019,대구광역시,2438031,1205286,1232745,4354776,278815
2019,대구광역시,2438031,1205286,1232745,627376,84382
2019,대구광역시,2438031,1205286,1232745,625957,77520
2019,대구광역시,2438031,1205286,1232745,850525,107609
2019,대구광역시,2438031,1205286,1232745,724524,91138
2019,대구광역시,2438031,1205286,1232745,787816,121767
2019,대구광역시,2438031,1205286,1232745,1081216,143560
2019,대구광역시,2438031,1205286,1232745,1266739,147173
2019,대구광역시,2438031,1205286,1232745,241788,36566
2019,인천광역시,2957026,1482249,1474777,2953964,93402
2019,인천광역시,2957026,1482249,1474777,1249757,109651
2019,인천광역시,2957026,1482249,1474777,800340,40721
2019,인천광역시,2957026,1482249,1474777,1019365,66695
2019,인천광역시,2957026,1482249,1474777,526161,39625
2019,인천광역시,2957026,1482249,1474777,492797,29640
2019,인천광역시,2957026,1482249,1474777,391596,33114
2019,인천광역시,2957026,1482249,1474777,132257,16437
2019,인천광역시,2957026,1482249,1474777,4354776,278815
2019,인천광역시,2957026,1482249,1474777,627376,84382
2019,인천광역시,2957026,1482249,1474777,625957,77520
2019,인천광역시,2957026,1482249,1474777,850525,107609
2019,인천광역시,2957026,1482249,1474777,724524,91138
2019,인천광역시,2957026,1482249,1474777,787816,121767
2019,인천광역시,2957026,1482249,1474777,1081216,143560
2019,인천광역시,2957026,1482249,1474777,1266739,147173
2019,인천광역시,2957026,1482249,1474777,241788,36566
2019,광주광역시,1456468,720740,735728,2953964,93402
2019,광주광역시,1456468,720740,735728,1249757,109651
2019,광주광역시,1456468,720740,735728,800340,40721
2019,광주광역시,1456468,720740,735728,1019365,66695
2019,광주광역시,1456468,720740,735728,526161,39625
2019,광주광역시,1456468,720740,735728,492797,29640
2019,광주광역시,1456468,720740,735728,391596,33114
2019,광주광역시,1456468,720740,735728,132257,16437
2019,광주광역시,1456468,720740,735728,4354776,278815
2019,광주광역시,1456468,720740,735728,627376,84382
2019,광주광역시,1456468,720740,735728,625957,77520
2019,광주광역시,1456468,720740,735728,850525,107609
2019,광주광역시,1456468,720740,735728,724524,91138
2019,광주광역시,1456468,720740,735728,787816,121767
2019,광주광역시,1456468,720740,735728,1081216,143560
2019,광주광역시,1456468,720740,735728,1266739,147173
2019,광주광역시,1456468,720740,735728,241788,36566
2019,대전광역시,1474870,736607,738263,2953964,93402
2019,대전광역시,1474870,736607,738263,1249757,109651
2019,대전광역시,1474870,736607,738263,800340,40721
2019,대전광역시,1474870,736607,738263,1019365,66695
2019,대전광역시,1474870,736607,738263,526161,39625
2019,대전광역시,1474870,736607,738263,492797,29640
2019,대전광역시,1474870,736607,738263,391596,33114
2019,대전광역시,1474870,736607,738263,132257,16437
2019,대전광역시,1474870,736607,738263,4354776,278815
2019,대전광역시,1474870,736607,738263,627376,84382
2019,대전광역시,1474870,736607,738263,625957,77520
2019,대전광역시,1474870,736607,738263,850525,107609
2019,대전광역시,1474870,736607,738263,724524,91138
2019,대전광역시,1474870,736607,738263,787816,121767
2019,대전광역시,1474870,736607,738263,1081216,143560
2019,대전광역시,1474870,736607,738263,1266739,147173
2019,대전광역시,1474870,736607,738263,241788,36566
2019,울산광역시,1148019,589712,558307,2953964,93402
2019,울산광역시,1148019,589712,558307,1249757,109651
2019,울산광역시,1148019,589712,558307,800340,40721
2019,울산광역시,1148019,589712,558307,1019365,66695
2019,울산광역시,1148019,589712,558307,526161,39625
2019,울산광역시,1148019,589712,558307,492797,29640
2019,울산광역시,1148019,589712,558307,391596,33114
2019,울산광역시,1148019,589712,558307,132257,16437
2019,울산광역시,1148019,589712,558307,4354776,278815
2019,울산광역시,1148019,589712,558307,627376,84382
2019,울산광역시,1148019,589712,558307,625957,77520
2019,울산광역시,1148019,589712,558307,850525,107609
2019,울산광역시,1148019,589712,558307,724524,91138
2019,울산광역시,1148019,589712,558307,787816,121767
2019,울산광역시,1148019,589712,558307,1081216,143560
2019,울산광역시,1148019,589712,558307,1266739,147173
2019,울산광역시,1148019,589712,558307,241788,36566
2019,세종특별자치시,340575,169845,170730,2953964,93402
2019,세종특별자치시,340575,169845,170730,1249757,109651
2019,세종특별자치시,340575,169845,170730,800340,40721
2019,세종특별자치시,340575,169845,170730,1019365,66695
2019,세종특별자치시,340575,169845,170730,526161,39625
2019,세종특별자치시,340575,169845,170730,492797,29640
2019,세종특별자치시,340575,169845,170730,391596,33114
2019,세종특별자치시,340575,169845,170730,132257,16437
2019,세종특별자치시,340575,169845,170730,4354776,278815
2019,세종특별자치시,340575,169845,170730,627376,84382
2019,세종특별자치시,340575,169845,170730,625957,77520
2019,세종특별자치시,340575,169845,170730,850525,107609
2019,세종특별자치시,340575,169845,170730,724524,91138
2019,세종특별자치시,340575,169845,170730,787816,121767
2019,세종특별자치시,340575,169845,170730,1081216,143560
2019,세종특별자치시,340575,169845,170730,1266739,147173
2019,세종특별자치시,340575,169845,170730,241788,36566
2019,경기도,13239666,6659995,6579671,2953964,93402
2019,경기도,13239666,6659995,6579671,1249757,109651
2019,경기도,13239666,6659995,6579671,800340,40721
2019,경기도,13239666,6659995,6579671,1019365,66695
2019,경기도,13239666,6659995,6579671,526161,39625
2019,경기도,13239666,6659995,6579671,492797,29640
2019,경기도,13239666,6659995,6579671,391596,33114
2019,경기도,13239666,6659995,6579671,132257,16437
2019,경기도,13239666,6659995,6579671,4354776,278815
2019,경기도,13239666,6659995,6579671,627376,84382
2019,경기도,13239666,6659995,6579671,625957,77520
2019,경기도,13239666,6659995,6579671,850525,107609
2019,경기도,13239666,6659995,6579671,724524,91138
2019,경기도,13239666,6659995,6579671,787816,121767
2019,경기도,13239666,6659995,6579671,1081216,143560
2019,경기도,13239666,6659995,6579671,1266739,147173
2019,경기도,13239666,6659995,6579671,241788,36566
2019,강원도,1541502,775386,766116,2953964,93402
2019,강원도,1541502,775386,766116,1249757,109651
2019,강원도,1541502,775386,766116,800340,40721
2019,강원도,1541502,775386,766116,1019365,66695
2019,강원도,1541502,775386,766116,526161,39625
2019,강원도,1541502,775386,766116,492797,29640
2019,강원도,1541502,775386,766116,391596,33114
2019,강원도,1541502,775386,766116,132257,16437
2019,강원도,1541502,775386,766116,4354776,278815
2019,강원도,1541502,775386,766116,627376,84382
2019,강원도,1541502,775386,766116,625957,77520
2019,강원도,1541502,775386,766116,850525,107609
2019,강원도,1541502,775386,766116,724524,91138
2019,강원도,1541502,775386,766116,787816,121767
2019,강원도,1541502,775386,766116,1081216,143560
2019,강원도,1541502,775386,766116,1266739,147173
2019,강원도,1541502,775386,766116,241788,36566
2019,충청북도,1600007,810384,789623,2953964,93402
2019,충청북도,1600007,810384,789623,1249757,109651
2019,충청북도,1600007,810384,789623,800340,40721
2019,충청북도,1600007,810384,789623,1019365,66695
2019,충청북도,1600007,810384,789623,526161,39625
2019,충청북도,1600007,810384,789623,492797,29640
2019,충청북도,1600007,810384,789623,391596,33114
2019,충청북도,1600007,810384,789623,132257,16437
2019,충청북도,1600007,810384,789623,4354776,278815
2019,충청북도,1600007,810384,789623,627376,84382
2019,충청북도,1600007,810384,789623,625957,77520
2019,충청북도,1600007,810384,789623,850525,107609
2019,충청북도,1600007,810384,789623,724524,91138
2019,충청북도,1600007,810384,789623,787816,121767
2019,충청북도,1600007,810384,789623,1081216,143560
2019,충청북도,1600007,810384,789623,1266739,147173
2019,충청북도,1600007,810384,789623,241788,36566
2019,충청남도,2123709,1081938,1041771,2953964,93402
2019,충청남도,2123709,1081938,1041771,1249757,109651
2019,충청남도,2123709,1081938,1041771,800340,40721
2019,충청남도,2123709,1081938,1041771,1019365,66695
2019,충청남도,2123709,1081938,1041771,526161,39625
2019,충청남도,2123709,1081938,1041771,492797,29640
2019,충청남도,2123709,1081938,1041771,391596,33114
2019,충청남도,2123709,1081938,1041771,132257,16437
2019,충청남도,2123709,1081938,1041771,4354776,278815
2019,충청남도,2123709,1081938,1041771,627376,84382
2019,충청남도,2123709,1081938,1041771,625957,77520
2019,충청남도,2123709,1081938,1041771,850525,107609
2019,충청남도,2123709,1081938,1041771,724524,91138
2019,충청남도,2123709,1081938,1041771,787816,121767
2019,충청남도,2123709,1081938,1041771,1081216,143560
2019,충청남도,2123709,1081938,1041771,1266739,147173
2019,충청남도,2123709,1081938,1041771,241788,36566
2019,전라북도,1818917,904110,914807,2953964,93402
2019,전라북도,1818917,904110,914807,1249757,109651
2019,전라북도,1818917,904110,914807,800340,40721
2019,전라북도,1818917,904110,914807,1019365,66695
2019,전라북도,1818917,904110,914807,526161,39625
2019,전라북도,1818917,904110,914807,492797,29640
2019,전라북도,1818917,904110,914807,391596,33114
2019,전라북도,1818917,904110,914807,132257,16437
2019,전라북도,1818917,904110,914807,4354776,278815
2019,전라북도,1818917,904110,914807,627376,84382
2019,전라북도,1818917,904110,914807,625957,77520
2019,전라북도,1818917,904110,914807,850525,107609
2019,전라북도,1818917,904110,914807,724524,91138
2019,전라북도,1818917,904110,914807,787816,121767
2019,전라북도,1818917,904110,914807,1081216,143560
2019,전라북도,1818917,904110,914807,1266739,147173
2019,전라북도,1818917,904110,914807,241788,36566
2019,전라남도,1868745,937674,931071,2953964,93402
2019,전라남도,1868745,937674,931071,1249757,109651
2019,전라남도,1868745,937674,931071,800340,40721
2019,전라남도,1868745,937674,931071,1019365,66695
2019,전라남도,1868745,937674,931071,526161,39625
2019,전라남도,1868745,937674,931071,492797,29640
2019,전라남도,1868745,937674,931071,391596,33114
2019,전라남도,1868745,937674,931071,132257,16437
2019,전라남도,1868745,937674,931071,4354776,278815
2019,전라남도,1868745,937674,931071,627376,84382
2019,전라남도,1868745,937674,931071,625957,77520
2019,전라남도,1868745,937674,931071,850525,107609
2019,전라남도,1868745,937674,931071,724524,91138
2019,전라남도,1868745,937674,931071,787816,121767
2019,전라남도,1868745,937674,931071,1081216,143560
2019,전라남도,1868745,937674,931071,1266739,147173
2019,전라남도,1868745,937674,931071,241788,36566
2019,경상북도,2665836,1342037,1323799,2953964,93402
2019,경상북도,2665836,1342037,1323799,1249757,109651
2019,경상북도,2665836,1342037,1323799,800340,40721
2019,경상북도,2665836,1342037,1323799,1019365,66695
2019,경상북도,2665836,1342037,1323799,526161,39625
2019,경상북도,2665836,1342037,1323799,492797,29640
2019,경상북도,2665836,1342037,1323799,391596,33114
2019,경상북도,2665836,1342037,1323799,132257,16437
2019,경상북도,2665836,1342037,1323799,4354776,278815
2019,경상북도,2665836,1342037,1323799,627376,84382
2019,경상북도,2665836,1342037,1323799,625957,77520
2019,경상북도,2665836,1342037,1323799,850525,107609
2019,경상북도,2665836,1342037,1323799,724524,91138
2019,경상북도,2665836,1342037,1323799,787816,121767
2019,경상북도,2665836,1342037,1323799,1081216,143560
2019,경상북도,2665836,1342037,1323799,1266739,147173
2019,경상북도,2665836,1342037,1323799,241788,36566
2019,경상남도,3362553,1692032,1670521,2953964,93402
2019,경상남도,3362553,1692032,1670521,1249757,109651
2019,경상남도,3362553,1692032,1670521,800340,40721
2019,경상남도,3362553,1692032,1670521,1019365,66695
2019,경상남도,3362553,1692032,1670521,526161,39625
2019,경상남도,3362553,1692032,1670521,492797,29640
2019,경상남도,3362553,1692032,1670521,391596,33114
2019,경상남도,3362553,1692032,1670521,132257,16437
2019,경상남도,3362553,1692032,1670521,4354776,278815
2019,경상남도,3362553,1692032,1670521,627376,84382
2019,경상남도,3362553,1692032,1670521,625957,77520
2019,경상남도,3362553,1692032,1670521,850525,107609
2019,경상남도,3362553,1692032,1670521,724524,91138
2019,경상남도,3362553,1692032,1670521,787816,121767
2019,경상남도,3362553,1692032,1670521,1081216,143560
2019,경상남도,3362553,1692032,1670521,1266739,147173
2019,경상남도,3362553,1692032,1670521,241788,36566
2019,제주특별자치도,670989,337345,333644,2953964,93402
2019,제주특별자치도,670989,337345,333644,1249757,109651
2019,제주특별자치도,670989,337345,333644,800340,40721
2019,제주특별자치도,670989,337345,333644,1019365,66695
2019,제주특별자치도,670989,337345,333644,526161,39625
2019,제주특별자치도,670989,337345,333644,492797,29640
2019,제주특별자치도,670989,337345,333644,391596,33114
2019,제주특별자치도,670989,337345,333644,132257,16437
2019,제주특별자치도,670989,337345,333644,4354776,278815
2019,제주특별자치도,670989,337345,333644,627376,84382
2019,제주특별자치도,670989,337345,333644,625957,77520
2019,제주특별자치도,670989,337345,333644,850525,107609
2019,제주특별자치도,670989,337345,333644,724524,91138
2019,제주특별자치도,670989,337345,333644,787816,121767
2019,제주특별자치도,670989,337345,333644,1081216,143560
2019,제주특별자치도,670989,337345,333644,1266739,147173
2019,제주특별자치도,670989,337345,333644,241788,36566
2020,서울특별시,9668465,4701723,4966742,3015371,96629
2020,서울특별시,9668465,4701723,4966742,1275859,113410
2020,서울특별시,9668465,4701723,4966742,809802,39069
2020,서울특별시,9668465,4701723,4966742,1032774,65861
2020,서울특별시,9668465,4701723,4966742,538275,41585
2020,서울특별시,9668465,4701723,4966742,496875,26983
2020,서울특별시,9668465,4701723,4966742,394634,30241
2020,서울특별시,9668465,4701723,4966742,136887,14385
2020,서울특별시,9668465,4701723,4966742,4495115,272358
2020,서울특별시,9668465,4701723,4966742,644023,84106
2020,서울특별시,9668465,4701723,4966742,640256,76877
2020,서울특별시,9668465,4701723,4966742,865008,106430
2020,서울특별시,9668465,4701723,4966742,741221,95412
2020,서울특별시,9668465,4701723,4966742,802043,122103
2020,서울특별시,9668465,4701723,4966742,1094306,139770
2020,서울특별시,9668465,4701723,4966742,1296944,150982
2020,서울특별시,9668465,4701723,4966742,246451,35105
2020,부산광역시,3391946,1661000,1730946,3015371,96629
2020,부산광역시,3391946,1661000,1730946,1275859,113410
2020,부산광역시,3391946,1661000,1730946,809802,39069
2020,부산광역시,3391946,1661000,1730946,1032774,65861
2020,부산광역시,3391946,1661000,1730946,538275,41585
2020,부산광역시,3391946,1661000,1730946,496875,26983
2020,부산광역시,3391946,1661000,1730946,394634,30241
2020,부산광역시,3391946,1661000,1730946,136887,14385
2020,부산광역시,3391946,1661000,1730946,4495115,272358
2020,부산광역시,3391946,1661000,1730946,644023,84106
2020,부산광역시,3391946,1661000,1730946,640256,76877
2020,부산광역시,3391946,1661000,1730946,865008,106430
2020,부산광역시,3391946,1661000,1730946,741221,95412
2020,부산광역시,3391946,1661000,1730946,802043,122103
2020,부산광역시,3391946,1661000,1730946,1094306,139770
2020,부산광역시,3391946,1661000,1730946,1296944,150982
2020,부산광역시,3391946,1661000,1730946,246451,35105
2020,대구광역시,2418346,1193109,1225237,3015371,96629
2020,대구광역시,2418346,1193109,1225237,1275859,113410
2020,대구광역시,2418346,1193109,1225237,809802,39069
2020,대구광역시,2418346,1193109,1225237,1032774,65861
2020,대구광역시,2418346,1193109,1225237,538275,41585
2020,대구광역시,2418346,1193109,1225237,496875,26983
2020,대구광역시,2418346,1193109,1225237,394634,30241
2020,대구광역시,2418346,1193109,1225237,136887,14385
2020,대구광역시,2418346,1193109,1225237,4495115,272358
2020,대구광역시,2418346,1193109,1225237,644023,84106
2020,대구광역시,2418346,1193109,1225237,640256,76877
2020,대구광역시,2418346,1193109,1225237,865008,106430
2020,대구광역시,2418346,1193109,1225237,741221,95412
2020,대구광역시,2418346,1193109,1225237,802043,122103
2020,대구광역시,2418346,1193109,1225237,1094306,139770
2020,대구광역시,2418346,1193109,1225237,1296944,150982
2020,대구광역시,2418346,1193109,1225237,246451,35105
2020,인천광역시,2942828,1473943,1468885,3015371,96629
2020,인천광역시,2942828,1473943,1468885,1275859,113410
2020,인천광역시,2942828,1473943,1468885,809802,39069
2020,인천광역시,2942828,1473943,1468885,1032774,65861
2020,인천광역시,2942828,1473943,1468885,538275,41585
2020,인천광역시,2942828,1473943,1468885,496875,26983
2020,인천광역시,2942828,1473943,1468885,394634,30241
2020,인천광역시,2942828,1473943,1468885,136887,14385
2020,인천광역시,2942828,1473943,1468885,4495115,272358
2020,인천광역시,2942828,1473943,1468885,644023,84106
2020,인천광역시,2942828,1473943,1468885,640256,76877
2020,인천광역시,2942828,1473943,1468885,865008,106430
2020,인천광역시,2942828,1473943,1468885,741221,95412
2020,인천광역시,2942828,1473943,1468885,802043,122103
2020,인천광역시,2942828,1473943,1468885,1094306,139770
2020,인천광역시,2942828,1473943,1468885,1296944,150982
2020,인천광역시,2942828,1473943,1468885,246451,35105
2020,광주광역시,1450062,717348,732714,3015371,96629
2020,광주광역시,1450062,717348,732714,1275859,113410
2020,광주광역시,1450062,717348,732714,809802,39069
2020,광주광역시,1450062,717348,732714,1032774,65861
2020,광주광역시,1450062,717348,732714,538275,41585
2020,광주광역시,1450062,717348,732714,496875,26983
2020,광주광역시,1450062,717348,732714,394634,30241
2020,광주광역시,1450062,717348,732714,136887,14385
2020,광주광역시,1450062,717348,732714,4495115,272358
2020,광주광역시,1450062,717348,732714,644023,84106
2020,광주광역시,1450062,717348,732714,640256,76877
2020,광주광역시,1450062,717348,732714,865008,106430
2020,광주광역시,1450062,717348,732714,741221,95412
2020,광주광역시,1450062,717348,732714,802043,122103
2020,광주광역시,1450062,717348,732714,1094306,139770
2020,광주광역시,1450062,717348,732714,1296944,150982
2020,광주광역시,1450062,717348,732714,246451,35105
2020,대전광역시,1463882,730699,733183,3015371,96629
2020,대전광역시,1463882,730699,733183,1275859,113410
2020,대전광역시,1463882,730699,733183,809802,39069
2020,대전광역시,1463882,730699,733183,1032774,65861
2020,대전광역시,1463882,730699,733183,538275,41585
2020,대전광역시,1463882,730699,733183,496875,26983
2020,대전광역시,1463882,730699,733183,394634,30241
2020,대전광역시,1463882,730699,733183,136887,14385
2020,대전광역시,1463882,730699,733183,4495115,272358
2020,대전광역시,1463882,730699,733183,644023,84106
2020,대전광역시,1463882,730699,733183,640256,76877
2020,대전광역시,1463882,730699,733183,865008,106430
2020,대전광역시,1463882,730699,733183,741221,95412
2020,대전광역시,1463882,730699,733183,802043,122103
2020,대전광역시,1463882,730699,733183,1094306,139770
2020,대전광역시,1463882,730699,733183,1296944,150982
2020,대전광역시,1463882,730699,733183,246451,35105
2020,울산광역시,1136017,583708,552309,3015371,96629
2020,울산광역시,1136017,583708,552309,1275859,113410
2020,울산광역시,1136017,583708,552309,809802,39069
2020,울산광역시,1136017,583708,552309,1032774,65861
2020,울산광역시,1136017,583708,552309,538275,41585
2020,울산광역시,1136017,583708,552309,496875,26983
2020,울산광역시,1136017,583708,552309,394634,30241
2020,울산광역시,1136017,583708,552309,136887,14385
2020,울산광역시,1136017,583708,552309,4495115,272358
2020,울산광역시,1136017,583708,552309,644023,84106
2020,울산광역시,1136017,583708,552309,640256,76877
2020,울산광역시,1136017,583708,552309,865008,106430
2020,울산광역시,1136017,583708,552309,741221,95412
2020,울산광역시,1136017,583708,552309,802043,122103
2020,울산광역시,1136017,583708,552309,1094306,139770
2020,울산광역시,1136017,583708,552309,1296944,150982
2020,울산광역시,1136017,583708,552309,246451,35105
2020,세종특별자치시,355831,177568,178263,3015371,96629
2020,세종특별자치시,355831,177568,178263,1275859,113410
2020,세종특별자치시,355831,177568,178263,809802,39069
2020,세종특별자치시,355831,177568,178263,1032774,65861
2020,세종특별자치시,355831,177568,178263,538275,41585
2020,세종특별자치시,355831,177568,178263,496875,26983
2020,세종특별자치시,355831,177568,178263,394634,30241
2020,세종특별자치시,355831,177568,178263,136887,14385
2020,세종특별자치시,355831,177568,178263,4495115,272358
2020,세종특별자치시,355831,177568,178263,644023,84106
2020,세종특별자치시,355831,177568,178263,640256,76877
2020,세종특별자치시,355831,177568,178263,865008,106430
2020,세종특별자치시,355831,177568,178263,741221,95412
2020,세종특별자치시,355831,177568,178263,802043,122103
2020,세종특별자치시,355831,177568,178263,1094306,139770
2020,세종특별자치시,355831,177568,178263,1296944,150982
2020,세종특별자치시,355831,177568,178263,246451,35105
2020,경기도,13427014,6754469,6672545,3015371,96629
2020,경기도,13427014,6754469,6672545,1275859,113410
2020,경기도,13427014,6754469,6672545,809802,39069
2020,경기도,13427014,6754469,6672545,1032774,65861
2020,경기도,13427014,6754469,6672545,538275,41585
2020,경기도,13427014,6754469,6672545,496875,26983
2020,경기도,13427014,6754469,6672545,394634,30241
2020,경기도,13427014,6754469,6672545,136887,14385
2020,경기도,13427014,6754469,6672545,4495115,272358
2020,경기도,13427014,6754469,6672545,644023,84106
2020,경기도,13427014,6754469,6672545,640256,76877
2020,경기도,13427014,6754469,6672545,865008,106430
2020,경기도,13427014,6754469,6672545,741221,95412
2020,경기도,13427014,6754469,6672545,802043,122103
2020,경기도,13427014,6754469,6672545,1094306,139770
2020,경기도,13427014,6754469,6672545,1296944,150982
2020,경기도,13427014,6754469,6672545,246451,35105
2020,강원도,1542840,776505,766335,3015371,96629
2020,강원도,1542840,776505,766335,1275859,113410
2020,강원도,1542840,776505,766335,809802,39069
2020,강원도,1542840,776505,766335,1032774,65861
2020,강원도,1542840,776505,766335,538275,41585
2020,강원도,1542840,776505,766335,496875,26983
2020,강원도,1542840,776505,766335,394634,30241
2020,강원도,1542840,776505,766335,136887,14385
2020,강원도,1542840,776505,766335,4495115,272358
2020,강원도,1542840,776505,766335,644023,84106
2020,강원도,1542840,776505,766335,640256,76877
2020,강원도,1542840,776505,766335,865008,106430
2020,강원도,1542840,776505,766335,741221,95412
2020,강원도,1542840,776505,766335,802043,122103
2020,강원도,1542840,776505,766335,1094306,139770
2020,강원도,1542840,776505,766335,1296944,150982
2020,강원도,1542840,776505,766335,246451,35105
2020,충청북도,1600837,811591,789246,3015371,96629
2020,충청북도,1600837,811591,789246,1275859,113410
2020,충청북도,1600837,811591,789246,809802,39069
2020,충청북도,1600837,811591,789246,1032774,65861
2020,충청북도,1600837,811591,789246,538275,41585
2020,충청북도,1600837,811591,789246,496875,26983
2020,충청북도,1600837,811591,789246,394634,30241
2020,충청북도,1600837,811591,789246,136887,14385
2020,충청북도,1600837,811591,789246,4495115,272358
2020,충청북도,1600837,811591,789246,644023,84106
2020,충청북도,1600837,811591,789246,640256,76877
2020,충청북도,1600837,811591,789246,865008,106430
2020,충청북도,1600837,811591,789246,741221,95412
2020,충청북도,1600837,811591,789246,802043,122103
2020,충청북도,1600837,811591,789246,1094306,139770
2020,충청북도,1600837,811591,789246,1296944,150982
2020,충청북도,1600837,811591,789246,246451,35105
2020,충청남도,2121029,1082634,1038395,3015371,96629
2020,충청남도,2121029,1082634,1038395,1275859,113410
2020,충청남도,2121029,1082634,1038395,809802,39069
2020,충청남도,2121029,1082634,1038395,1032774,65861
2020,충청남도,2121029,1082634,1038395,538275,41585
2020,충청남도,2121029,1082634,1038395,496875,26983
2020,충청남도,2121029,1082634,1038395,394634,30241
2020,충청남도,2121029,1082634,1038395,136887,14385
2020,충청남도,2121029,1082634,1038395,4495115,272358
2020,충청남도,2121029,1082634,1038395,644023,84106
2020,충청남도,2121029,1082634,1038395,640256,76877
2020,충청남도,2121029,1082634,1038395,865008,106430
2020,충청남도,2121029,1082634,1038395,741221,95412
2020,충청남도,2121029,1082634,1038395,802043,122103
2020,충청남도,2121029,1082634,1038395,1094306,139770
2020,충청남도,2121029,1082634,1038395,1296944,150982
2020,충청남도,2121029,1082634,1038395,246451,35105
2020,전라북도,1804104,896874,907230,3015371,96629
2020,전라북도,1804104,896874,907230,1275859,113410
2020,전라북도,1804104,896874,907230,809802,39069
2020,전라북도,1804104,896874,907230,1032774,65861
2020,전라북도,1804104,896874,907230,538275,41585
2020,전라북도,1804104,896874,907230,496875,26983
2020,전라북도,1804104,896874,907230,394634,30241
2020,전라북도,1804104,896874,907230,136887,14385
2020,전라북도,1804104,896874,907230,4495115,272358
2020,전라북도,1804104,896874,907230,644023,84106
2020,전라북도,1804104,896874,907230,640256,76877
2020,전라북도,1804104,896874,907230,865008,106430
2020,전라북도,1804104,896874,907230,741221,95412
2020,전라북도,1804104,896874,907230,802043,122103
2020,전라북도,1804104,896874,907230,1094306,139770
2020,전라북도,1804104,896874,907230,1296944,150982
2020,전라북도,1804104,896874,907230,246451,35105
2020,전라남도,1851549,930615,920934,3015371,96629
2020,전라남도,1851549,930615,920934,1275859,113410
2020,전라남도,1851549,930615,920934,809802,39069
2020,전라남도,1851549,930615,920934,1032774,65861
2020,전라남도,1851549,930615,920934,538275,41585
2020,전라남도,1851549,930615,920934,496875,26983
2020,전라남도,1851549,930615,920934,394634,30241
2020,전라남도,1851549,930615,920934,136887,14385
2020,전라남도,1851549,930615,920934,4495115,272358
2020,전라남도,1851549,930615,920934,644023,84106
2020,전라남도,1851549,930615,920934,640256,76877
2020,전라남도,1851549,930615,920934,865008,106430
2020,전라남도,1851549,930615,920934,741221,95412
2020,전라남도,1851549,930615,920934,802043,122103
2020,전라남도,1851549,930615,920934,1094306,139770
2020,전라남도,1851549,930615,920934,1296944,150982
2020,전라남도,1851549,930615,920934,246451,35105
2020,경상북도,2639422,1329211,1310211,3015371,96629
2020,경상북도,2639422,1329211,1310211,1275859,113410
2020,경상북도,2639422,1329211,1310211,809802,39069
2020,경상북도,2639422,1329211,1310211,1032774,65861
2020,경상북도,2639422,1329211,1310211,538275,41585
2020,경상북도,2639422,1329211,1310211,496875,26983
2020,경상북도,2639422,1329211,1310211,394634,30241
2020,경상북도,2639422,1329211,1310211,136887,14385
2020,경상북도,2639422,1329211,1310211,4495115,272358
2020,경상북도,2639422,1329211,1310211,644023,84106
2020,경상북도,2639422,1329211,1310211,640256,76877
2020,경상북도,2639422,1329211,1310211,865008,106430
2020,경상북도,2639422,1329211,1310211,741221,95412
2020,경상북도,2639422,1329211,1310211,802043,122103
2020,경상북도,2639422,1329211,1310211,1094306,139770
2020,경상북도,2639422,1329211,1310211,1296944,150982
2020,경상북도,2639422,1329211,1310211,246451,35105
2020,경상남도,3340216,1681423,1658793,3015371,96629
2020,경상남도,3340216,1681423,1658793,1275859,113410
2020,경상남도,3340216,1681423,1658793,809802,39069
2020,경상남도,3340216,1681423,1658793,1032774,65861
2020,경상남도,3340216,1681423,1658793,538275,41585
2020,경상남도,3340216,1681423,1658793,496875,26983
2020,경상남도,3340216,1681423,1658793,394634,30241
2020,경상남도,3340216,1681423,1658793,136887,14385
2020,경상남도,3340216,1681423,1658793,4495115,272358
2020,경상남도,3340216,1681423,1658793,644023,84106
2020,경상남도,3340216,1681423,1658793,640256,76877
2020,경상남도,3340216,1681423,1658793,865008,106430
2020,경상남도,3340216,1681423,1658793,741221,95412
2020,경상남도,3340216,1681423,1658793,802043,122103
2020,경상남도,3340216,1681423,1658793,1094306,139770
2020,경상남도,3340216,1681423,1658793,1296944,150982
2020,경상남도,3340216,1681423,1658793,246451,35105
2020,제주특별자치도,674635,338609,336026,3015371,96629
2020,제주특별자치도,674635,338609,336026,1275859,113410
2020,제주특별자치도,674635,338609,336026,809802,39069
2020,제주특별자치도,674635,338609,336026,1032774,65861
2020,제주특별자치도,674635,338609,336026,538275,41585
2020,제주특별자치도,674635,338609,336026,496875,26983
2020,제주특별자치도,674635,338609,336026,394634,30241
2020,제주특별자치도,674635,338609,336026,136887,14385
2020,제주특별자치도,674635,338609,336026,4495115,272358
2020,제주특별자치도,674635,338609,336026,644023,84106
2020,제주특별자치도,674635,338609,336026,640256,76877
2020,제주특별자치도,674635,338609,336026,865008,106430
2020,제주특별자치도,674635,338609,336026,741221,95412
2020,제주특별자치도,674635,338609,336026,802043,122103
2020,제주특별자치도,674635,338609,336026,1094306,139770
2020,제주특별자치도,674635,338609,336026,1296944,150982
2020,제주특별자치도,674635,338609,336026,246451,35105
2021,서울특별시,9509458,4618040,4891418,3068494,97000
2021,서울특별시,9509458,4618040,4891418,1282831,101337
2021,서울특별시,9509458,4618040,4891418,815588,36121
2021,서울특별시,9509458,4618040,4891418,1053451,62748
2021,서울특별시,9509458,4618040,4891418,542703,33439
2021,서울특별시,9509458,4618040,4891418,501218,26005
2021,서울특별시,9509458,4618040,4891418,396893,29293
2021,서울특별시,9509458,4618040,4891418,143798,13223
2021,서울특별시,9509458,4618040,4891418,4608126,242181
2021,서울특별시,9509458,4618040,4891418,654719,80738
2021,서울특별시,9509458,4618040,4891418,650224,70258
2021,서울특별시,9509458,4618040,4891418,874666,96673
2021,서울특별시,9509458,4618040,4891418,747880,89358
2021,서울특별시,9509458,4618040,4891418,811478,116001
2021,서울특별시,9509458,4618040,4891418,1103666,129848
2021,서울특별시,9509458,4618040,4891418,1306263,138586
2021,서울특별시,9509458,4618040,4891418,249629,32447
2021,부산광역시,3350380,1639044,1711336,3068494,97000
2021,부산광역시,3350380,1639044,1711336,1282831,101337
2021,부산광역시,3350380,1639044,1711336,815588,36121
2021,부산광역시,3350380,1639044,1711336,1053451,62748
2021,부산광역시,3350380,1639044,1711336,542703,33439
2021,부산광역시,3350380,1639044,1711336,501218,26005
2021,부산광역시,3350380,1639044,1711336,396893,29293
2021,부산광역시,3350380,1639044,1711336,143798,13223
2021,부산광역시,3350380,1639044,1711336,4608126,242181
2021,부산광역시,3350380,1639044,1711336,654719,80738
2021,부산광역시,3350380,1639044,1711336,650224,70258
2021,부산광역시,3350380,1639044,1711336,874666,96673
2021,부산광역시,3350380,1639044,1711336,747880,89358
2021,부산광역시,3350380,1639044,1711336,811478,116001
2021,부산광역시,3350380,1639044,1711336,1103666,129848
2021,부산광역시,3350380,1639044,1711336,1306263,138586
2021,부산광역시,3350380,1639044,1711336,249629,32447
2021,대구광역시,2385412,1175632,1209780,3068494,97000
2021,대구광역시,2385412,1175632,1209780,1282831,101337
2021,대구광역시,2385412,1175632,1209780,815588,36121
2021,대구광역시,2385412,1175632,1209780,1053451,62748
2021,대구광역시,2385412,1175632,1209780,542703,33439
2021,대구광역시,2385412,1175632,1209780,501218,26005
2021,대구광역시,2385412,1175632,1209780,396893,29293
2021,대구광역시,2385412,1175632,1209780,143798,13223
2021,대구광역시,2385412,1175632,1209780,4608126,242181
2021,대구광역시,2385412,1175632,1209780,654719,80738
2021,대구광역시,2385412,1175632,1209780,650224,70258
2021,대구광역시,2385412,1175632,1209780,874666,96673
2021,대구광역시,2385412,1175632,1209780,747880,89358
2021,대구광역시,2385412,1175632,1209780,811478,116001
2021,대구광역시,2385412,1175632,1209780,1103666,129848
2021,대구광역시,2385412,1175632,1209780,1306263,138586
2021,대구광역시,2385412,1175632,1209780,249629,32447
2021,인천광역시,2948375,1476373,1472002,3068494,97000
2021,인천광역시,2948375,1476373,1472002,1282831,101337
2021,인천광역시,2948375,1476373,1472002,815588,36121
2021,인천광역시,2948375,1476373,1472002,1053451,62748
2021,인천광역시,2948375,1476373,1472002,542703,33439
2021,인천광역시,2948375,1476373,1472002,501218,26005
2021,인천광역시,2948375,1476373,1472002,396893,29293
2021,인천광역시,2948375,1476373,1472002,143798,13223
2021,인천광역시,2948375,1476373,1472002,4608126,242181
2021,인천광역시,2948375,1476373,1472002,654719,80738
2021,인천광역시,2948375,1476373,1472002,650224,70258
2021,인천광역시,2948375,1476373,1472002,874666,96673
2021,인천광역시,2948375,1476373,1472002,747880,89358
2021,인천광역시,2948375,1476373,1472002,811478,116001
2021,인천광역시,2948375,1476373,1472002,1103666,129848
2021,인천광역시,2948375,1476373,1472002,1306263,138586
2021,인천광역시,2948375,1476373,1472002,249629,32447
2021,광주광역시,1441611,713015,728596,3068494,97000
2021,광주광역시,1441611,713015,728596,1282831,101337
2021,광주광역시,1441611,713015,728596,815588,36121
2021,광주광역시,1441611,713015,728596,1053451,62748
2021,광주광역시,1441611,713015,728596,542703,33439
2021,광주광역시,1441611,713015,728596,501218,26005
2021,광주광역시,1441611,713015,728596,396893,29293
2021,광주광역시,1441611,713015,728596,143798,13223
2021,광주광역시,1441611,713015,728596,4608126,242181
2021,광주광역시,1441611,713015,728596,654719,80738
2021,광주광역시,1441611,713015,728596,650224,70258
2021,광주광역시,1441611,713015,728596,874666,96673
2021,광주광역시,1441611,713015,728596,747880,89358
2021,광주광역시,1441611,713015,728596,811478,116001
2021,광주광역시,1441611,713015,728596,1103666,129848
2021,광주광역시,1441611,713015,728596,1306263,138586
2021,광주광역시,1441611,713015,728596,249629,32447
2021,대전광역시,1452251,724626,727625,3068494,97000
2021,대전광역시,1452251,724626,727625,1282831,101337
2021,대전광역시,1452251,724626,727625,815588,36121
2021,대전광역시,1452251,724626,727625,1053451,62748
2021,대전광역시,1452251,724626,727625,542703,33439
2021,대전광역시,1452251,724626,727625,501218,26005
2021,대전광역시,1452251,724626,727625,396893,29293
2021,대전광역시,1452251,724626,727625,143798,13223
2021,대전광역시,1452251,724626,727625,4608126,242181
2021,대전광역시,1452251,724626,727625,654719,80738
2021,대전광역시,1452251,724626,727625,650224,70258
2021,대전광역시,1452251,724626,727625,874666,96673
2021,대전광역시,1452251,724626,727625,747880,89358
2021,대전광역시,1452251,724626,727625,811478,116001
2021,대전광역시,1452251,724626,727625,1103666,129848
2021,대전광역시,1452251,724626,727625,1306263,138586
2021,대전광역시,1452251,724626,727625,249629,32447
2021,울산광역시,1121592,576217,545375,3068494,97000
2021,울산광역시,1121592,576217,545375,1282831,101337
2021,울산광역시,1121592,576217,545375,815588,36121
2021,울산광역시,1121592,576217,545375,1053451,62748
2021,울산광역시,1121592,576217,545375,542703,33439
2021,울산광역시,1121592,576217,545375,501218,26005
2021,울산광역시,1121592,576217,545375,396893,29293
2021,울산광역시,1121592,576217,545375,143798,13223
2021,울산광역시,1121592,576217,545375,4608126,242181
2021,울산광역시,1121592,576217,545375,654719,80738
2021,울산광역시,1121592,576217,545375,650224,70258
2021,울산광역시,1121592,576217,545375,874666,96673
2021,울산광역시,1121592,576217,545375,747880,89358
2021,울산광역시,1121592,576217,545375,811478,116001
2021,울산광역시,1121592,576217,545375,1103666,129848
2021,울산광역시,1121592,576217,545375,1306263,138586
2021,울산광역시,1121592,576217,545375,249629,32447
2021,세종특별자치시,371895,185678,186217,3068494,97000
2021,세종특별자치시,371895,185678,186217,1282831,101337
2021,세종특별자치시,371895,185678,186217,815588,36121
2021,세종특별자치시,371895,185678,186217,1053451,62748
2021,세종특별자치시,371895,185678,186217,542703,33439
2021,세종특별자치시,371895,185678,186217,501218,26005
2021,세종특별자치시,371895,185678,186217,396893,29293
2021,세종특별자치시,371895,185678,186217,143798,13223
2021,세종특별자치시,371895,185678,186217,4608126,242181
2021,세종특별자치시,371895,185678,186217,654719,80738
2021,세종특별자치시,371895,185678,186217,650224,70258
2021,세종특별자치시,371895,185678,186217,874666,96673
2021,세종특별자치시,371895,185678,186217,747880,89358
2021,세종특별자치시,371895,185678,186217,811478,116001
2021,세종특별자치시,371895,185678,186217,1103666,129848
2021,세종특별자치시,371895,185678,186217,1306263,138586
2021,세종특별자치시,371895,185678,186217,249629,32447
2021,경기도,13565450,6827298,6738152,3068494,97000
2021,경기도,13565450,6827298,6738152,1282831,101337
2021,경기도,13565450,6827298,6738152,815588,36121
2021,경기도,13565450,6827298,6738152,1053451,62748
2021,경기도,13565450,6827298,6738152,542703,33439
2021,경기도,13565450,6827298,6738152,501218,26005
2021,경기도,13565450,6827298,6738152,396893,29293
2021,경기도,13565450,6827298,6738152,143798,13223
2021,경기도,13565450,6827298,6738152,4608126,242181
2021,경기도,13565450,6827298,6738152,654719,80738
2021,경기도,13565450,6827298,6738152,650224,70258
2021,경기도,13565450,6827298,6738152,874666,96673
2021,경기도,13565450,6827298,6738152,747880,89358
2021,경기도,13565450,6827298,6738152,811478,116001
2021,경기도,13565450,6827298,6738152,1103666,129848
2021,경기도,13565450,6827298,6738152,1306263,138586
2021,경기도,13565450,6827298,6738152,249629,32447
2021,강원도,1538492,774332,764160,3068494,97000
2021,강원도,1538492,774332,764160,1282831,101337
2021,강원도,1538492,774332,764160,815588,36121
2021,강원도,1538492,774332,764160,1053451,62748
2021,강원도,1538492,774332,764160,542703,33439
2021,강원도,1538492,774332,764160,501218,26005
2021,강원도,1538492,774332,764160,396893,29293
2021,강원도,1538492,774332,764160,143798,13223
2021,강원도,1538492,774332,764160,4608126,242181
2021,강원도,1538492,774332,764160,654719,80738
2021,강원도,1538492,774332,764160,650224,70258
2021,강원도,1538492,774332,764160,874666,96673
2021,강원도,1538492,774332,764160,747880,89358
2021,강원도,1538492,774332,764160,811478,116001
2021,강원도,1538492,774332,764160,1103666,129848
2021,강원도,1538492,774332,764160,1306263,138586
2021,강원도,1538492,774332,764160,249629,32447
2021,충청북도,1597427,810672,786755,3068494,97000
2021,충청북도,1597427,810672,786755,1282831,101337
2021,충청북도,1597427,810672,786755,815588,36121
2021,충청북도,1597427,810672,786755,1053451,62748
2021,충청북도,1597427,810672,786755,542703,33439
2021,충청북도,1597427,810672,786755,501218,26005
2021,충청북도,1597427,810672,786755,396893,29293
2021,충청북도,1597427,810672,786755,143798,13223
2021,충청북도,1597427,810672,786755,4608126,242181
2021,충청북도,1597427,810672,786755,654719,80738
2021,충청북도,1597427,810672,786755,650224,70258
2021,충청북도,1597427,810672,786755,874666,96673
2021,충청북도,1597427,810672,786755,747880,89358
2021,충청북도,1597427,810672,786755,811478,116001
2021,충청북도,1597427,810672,786755,1103666,129848
2021,충청북도,1597427,810672,786755,1306263,138586
2021,충청북도,1597427,810672,786755,249629,32447
2021,충청남도,2119257,1083366,1035891,3068494,97000
2021,충청남도,2119257,1083366,1035891,1282831,101337
2021,충청남도,2119257,1083366,1035891,815588,36121
2021,충청남도,2119257,1083366,1035891,1053451,62748
2021,충청남도,2119257,1083366,1035891,542703,33439
2021,충청남도,2119257,1083366,1035891,501218,26005
2021,충청남도,2119257,1083366,1035891,396893,29293
2021,충청남도,2119257,1083366,1035891,143798,13223
2021,충청남도,2119257,1083366,1035891,4608126,242181
2021,충청남도,2119257,1083366,1035891,654719,80738
2021,충청남도,2119257,1083366,1035891,650224,70258
2021,충청남도,2119257,1083366,1035891,874666,96673
2021,충청남도,2119257,1083366,1035891,747880,89358
2021,충청남도,2119257,1083366,1035891,811478,116001
2021,충청남도,2119257,1083366,1035891,1103666,129848
2021,충청남도,2119257,1083366,1035891,1306263,138586
2021,충청남도,2119257,1083366,1035891,249629,32447
2021,전라북도,1786855,888994,897861,3068494,97000
2021,전라북도,1786855,888994,897861,1282831,101337
2021,전라북도,1786855,888994,897861,815588,36121
2021,전라북도,1786855,888994,897861,1053451,62748
2021,전라북도,1786855,888994,897861,542703,33439
2021,전라북도,1786855,888994,897861,501218,26005
2021,전라북도,1786855,888994,897861,396893,29293
2021,전라북도,1786855,888994,897861,143798,13223
2021,전라북도,1786855,888994,897861,4608126,242181
2021,전라북도,1786855,888994,897861,654719,80738
2021,전라북도,1786855,888994,897861,650224,70258
2021,전라북도,1786855,888994,897861,874666,96673
2021,전라북도,1786855,888994,897861,747880,89358
2021,전라북도,1786855,888994,897861,811478,116001
2021,전라북도,1786855,888994,897861,1103666,129848
2021,전라북도,1786855,888994,897861,1306263,138586
2021,전라북도,1786855,888994,897861,249629,32447
2021,전라남도,1832803,922221,910582,3068494,97000
2021,전라남도,1832803,922221,910582,1282831,101337
2021,전라남도,1832803,922221,910582,815588,36121
2021,전라남도,1832803,922221,910582,1053451,62748
2021,전라남도,1832803,922221,910582,542703,33439
2021,전라남도,1832803,922221,910582,501218,26005
2021,전라남도,1832803,922221,910582,396893,29293
2021,전라남도,1832803,922221,910582,143798,13223
2021,전라남도,1832803,922221,910582,4608126,242181
2021,전라남도,1832803,922221,910582,654719,80738
2021,전라남도,1832803,922221,910582,650224,70258
2021,전라남도,1832803,922221,910582,874666,96673
2021,전라남도,1832803,922221,910582,747880,89358
2021,전라남도,1832803,922221,910582,811478,116001
2021,전라남도,1832803,922221,910582,1103666,129848
2021,전라남도,1832803,922221,910582,1306263,138586
2021,전라남도,1832803,922221,910582,249629,32447
2021,경상북도,2626609,1323661,1302948,3068494,97000
2021,경상북도,2626609,1323661,1302948,1282831,101337
2021,경상북도,2626609,1323661,1302948,815588,36121
2021,경상북도,2626609,1323661,1302948,1053451,62748
2021,경상북도,2626609,1323661,1302948,542703,33439
2021,경상북도,2626609,1323661,1302948,501218,26005
2021,경상북도,2626609,1323661,1302948,396893,29293
2021,경상북도,2626609,1323661,1302948,143798,13223
2021,경상북도,2626609,1323661,1302948,4608126,242181
2021,경상북도,2626609,1323661,1302948,654719,80738
2021,경상북도,2626609,1323661,1302948,650224,70258
2021,경상북도,2626609,1323661,1302948,874666,96673
2021,경상북도,2626609,1323661,1302948,747880,89358
2021,경상북도,2626609,1323661,1302948,811478,116001
2021,경상북도,2626609,1323661,1302948,1103666,129848
2021,경상북도,2626609,1323661,1302948,1306263,138586
2021,경상북도,2626609,1323661,1302948,249629,32447
2021,경상남도,3314183,1668338,1645845,3068494,97000
2021,경상남도,3314183,1668338,1645845,1282831,101337
2021,경상남도,3314183,1668338,1645845,815588,36121
2021,경상남도,3314183,1668338,1645845,1053451,62748
2021,경상남도,3314183,1668338,1645845,542703,33439
2021,경상남도,3314183,1668338,1645845,501218,26005
2021,경상남도,3314183,1668338,1645845,396893,29293
2021,경상남도,3314183,1668338,1645845,143798,13223
2021,경상남도,3314183,1668338,1645845,4608126,242181
2021,경상남도,3314183,1668338,1645845,654719,80738
2021,경상남도,3314183,1668338,1645845,650224,70258
2021,경상남도,3314183,1668338,1645845,874666,96673
2021,경상남도,3314183,1668338,1645845,747880,89358
2021,경상남도,3314183,1668338,1645845,811478,116001
2021,경상남도,3314183,1668338,1645845,1103666,129848
2021,경상남도,3314183,1668338,1645845,1306263,138586
2021,경상남도,3314183,1668338,1645845,249629,32447
2021,제주특별자치도,676759,339177,337582,3068494,97000
2021,제주특별자치도,676759,339177,337582,1282831,101337
2021,제주특별자치도,676759,339177,337582,815588,36121
2021,제주특별자치도,676759,339177,337582,1053451,62748
2021,제주특별자치도,676759,339177,337582,542703,33439
2021,제주특별자치도,676759,339177,337582,501218,26005
2021,제주특별자치도,676759,339177,337582,396893,29293
2021,제주특별자치도,676759,339177,337582,143798,13223
2021,제주특별자치도,676759,339177,337582,4608126,242181
2021,제주특별자치도,676759,339177,337582,654719,80738
2021,제주특별자치도,676759,339177,337582,650224,70258
2021,제주특별자치도,676759,339177,337582,874666,96673
2021,제주특별자치도,676759,339177,337582,747880,89358
2021,제주특별자치도,676759,339177,337582,811478,116001
2021,제주특별자치도,676759,339177,337582,1103666,129848
2021,제주특별자치도,676759,339177,337582,1306263,138586
2021,제주특별자치도,676759,339177,337582,249629,32447
2022,서울특별시,9428372,4570048,4858324,,
2022,부산광역시,3317812,1619915,1697897,,
2022,대구광역시,2363691,1162865,1200826,,
2022,인천광역시,2967314,1485175,1482139,,
2022,광주광역시,1431050,707299,723751,,
2022,대전광역시,1446072,721245,724827,,
2022,울산광역시,1110663,570368,540295,,
2022,세종특별자치시,383591,191389,192202,,
2022,경기도,13589432,6839276,6750156,,
2022,강원도,1536498,772947,763551,,
2022,충청북도,1595058,810782,784276,,
2022,충청남도,2123037,1086632,1036405,,
2022,전라북도,1769607,880592,889015,,
2022,전라남도,1817697,915272,902425,,
2022,경상북도,2600492,1311881,1288611,,
2022,경상남도,3280493,1651675,1628818,,
2022,제주특별자치도,678159,339590,338569,,
